ааб	AA P <SPACE>
аад	AA T <SPACE>
аалиншье	AA LJ I N SH J EH <SPACE>
аалихан	AA LJ I H EH NG <SPACE>
аба	A V EH <SPACE>
абаа	A V AA <SPACE>
абааб	A V AA P <SPACE>
абаабди	A V AA B DJ I <SPACE>
абаад	A V AA T <SPACE>
абаахайн	A V AA H EE NG <SPACE>
абаба	A V EH V EH <SPACE>
абабабди	A V EH V EH B DJ I <SPACE>
абагал	A V EH L <SPACE>
абадаг	A V EH D EH K <SPACE>
абадагби	A V EH D EH G BJ I <SPACE>
абажа	A V EH ZH EH <SPACE>
абалга	A V EH L Gr EH <SPACE>
абанги	A V EH N GJ I <SPACE>
абанхай	A V EH N H EE <SPACE>
абанхайб	A V EH N H EE P <SPACE>
абань	A V EH NJ <SPACE>
абаралга	A V EH R EH L Gr EH <SPACE>
абарга	A V EH R Gr EH <SPACE>
абари	A V EH RJ I <SPACE>
абарыт	A V EH R Y T <SPACE>
абатайм	A V EH T EH M <SPACE>
абашахаар	A V EH SH EH H AA R <SPACE>
абашни	A V EH SH NJ I I <SPACE>
абаһаа	A V EH HH AA <SPACE>
абаһан	A V EH HH EH NG <SPACE>
абаһандаа	A V EH HH EH N D AA <SPACE>
абгазы	A B G A Z Y <SPACE>
абгамни	A V Gr EH M NJ I <SPACE>
абгань	A V Gr EH NJ <SPACE>
абида	A VJ I D EH <SPACE>
абын	A V Y NG <SPACE>
абьяастай	A VJ J AA S T EE <SPACE>
августын	A F G Uh S T Y NG <SPACE>
автобус	A F T O V Uh S <SPACE>
автобусшье	A F T O V Uh S SH J EH <SPACE>
автор	A F T EH R <SPACE>
агаар	A Gr AA R <SPACE>
агаараар	A Gr AA R AA R <SPACE>
агаараарнь	A Gr AA R AA R NJ <SPACE>
агаарай	A Gr AA R EE <SPACE>
аглаг	A G L EH K <SPACE>
агууехэ	A Gr UUh J EH H EH <SPACE>
агын	A Gr Y NG <SPACE>
агынхидта	A Gr Y N HJ I D T EH <SPACE>
адабашьян	A D EH V EH SH J A NG <SPACE>
адаглааб	A D EH G L AA P <SPACE>
адли	A D LJ I <SPACE>
адлихан	A D LJ I H EH NG <SPACE>
адляар	A D LJ I R EH R <SPACE>
адууһа	A D UUh HH EH <SPACE>
ажа	A ZH EH <SPACE>
ажабайдал	A ZH EH V EE D EH L EH L <SPACE>
ажабайдалаар	A ZH EH V EE D EH L AA R <SPACE>
ажабайдалаймни	A ZH EH V EE D EH L N EE M NJ I <SPACE>
ажабайдалда	A ZH EH V EE D EH L D EH <SPACE>
ажабайдалдаа	A ZH EH V EE D EH L D EH <SPACE>
ажабайдалдань	A ZH EH V EE D EH L D EH NJ <SPACE>
ажал	A ZH EH L <SPACE>
ажалаа	A ZH EH L AA <SPACE>
ажалаар	A ZH EH L AA R <SPACE>
ажалай	A ZH EH L EE <SPACE>
ажалаймни	A ZH EH L EE M NJ I <SPACE>
ажалайнгаа	A ZH EH L EE N G AA <SPACE>
ажалгүйдэнэ	A ZH EH L Gr UIs D EH N EH <SPACE>
ажалда	A ZH EH L D EH <SPACE>
ажалдаа	A ZH EH L D AA <SPACE>
ажалдань	A ZH EH L D EH NJ <SPACE>
ажалжа	A ZH EH L ZH EH <SPACE>
ажаллаа	A ZH EH L AA <SPACE>
ажаллагшад	A ZH EH L L EH K SH EH T <SPACE>
ажаллажа	A ZH EH L L EH ZH EH <SPACE>
ажаллана	A ZH EH L L EH N EH <SPACE>
ажаллаха	A ZH EH L L EH H EH <SPACE>
ажалтай	A ZH EH L T EE <SPACE>
ажалтайт	A ZH EH L T EH T EE <SPACE>
ажалшад	A ZH EH L SH EH T <SPACE>
ажалыень	A ZH EH L Y J EH NJ <SPACE>
ажалһаа	A ZH EH L HH AA <SPACE>
ажалһаань	A ZH EH L HH AA NJ <SPACE>
ажахы	A ZH EH H Y <SPACE>
ажахын	A ZH EH H Y NG <SPACE>
ажахынуудые	A ZH EH H Y N UUh D Y J EH <SPACE>
ажаябуулгатай	A ZH EH J A V UUh L Gr EH T EE <SPACE>
ажаһуугаад	A ZH EH HH UUh Gr AA T <SPACE>
ажаһуугшад	A ZH EH HH UUh G SH EH T <SPACE>
ажаһуудаг	A ZH EH HH UUh D EH K <SPACE>
ажаһуудал	A ZH EH HH UUh D EH L <SPACE>
ажаһуудалда	A ZH EH HH UUh D EH L D EH <SPACE>
ажаһууна	A ZH EH HH UUh N EH <SPACE>
ажаһуунаб	A ZH EH HH UUh N EH P <SPACE>
ажаһууһан	A ZH EH HH UUh HH EH NG <SPACE>
азатай	A Z EH T EE <SPACE>
ази	A ZJ I <SPACE>
азиин	A ZJ I NG <SPACE>
айл	EE L <SPACE>
айлай	EE L EE <SPACE>
айлайхи	A L EE HJ I <SPACE>
айлнууд	EE L N UUh T <SPACE>
айлшаар	EE L SH AA R <SPACE>
айлшадаа	EE L SH EH D AA <SPACE>
айлшадай	EE L SH EH D EE <SPACE>
айлшалжа	EE L SH EH L ZH EH <SPACE>
айлшалхадаа	EE L SH EH L H EH D AA <SPACE>
айлшан	EE L SH EH NG <SPACE>
аймаг	EE M EH Gr EH <SPACE>
аймагаар	EE M EH Gr AA R <SPACE>
аймагай	EE M EH Gr EE <SPACE>
аймагта	EE M EH K T EH <SPACE>
аймагтаа	EE M EH K T AA <SPACE>
аймагтамнай	EE M EH K T EH M N EE <SPACE>
аймагуудай	EE M EH Gr UUh D EE <SPACE>
аймагуудта	EE M EH Gr UUh T T EH <SPACE>
аймшагтай	EE M SH EH K T EE <SPACE>
айн	EE NG <SPACE>
айхабтар	EE H EH B T EH R <SPACE>
академи	A K A DJ I M BJ I <SPACE>
академидэ	A K A DJ I M EH D EH <SPACE>
академик	A K A DJ E MJ I K <SPACE>
академическэ	A K A DJ E MJ I CH E S K EH <SPACE>
алаабхиһаа	A L AA P HJ I HH AA <SPACE>
алаабшанаар	A L AA P SH EH N AA R <SPACE>
алангуагай	A L EH N G Uh A Gr EE <SPACE>
аласдурна	A L EH S D Uh R N <SPACE>
албан	A L V EH NG <SPACE>
алгадажа	A L Gr EH D EH ZH EH <SPACE>
алдаа	A L D AA <SPACE>
алдарта	A L D EH R T EH <SPACE>
алдаха	A L D EH H EH <SPACE>
алдаһан	A L D EH HH EH NG <SPACE>
алдуу	A L D Uh <SPACE>
алдуугүй	A L D Uh Gr UIs <SPACE>
александр	A LJ E K S A N D R <SPACE>
алексей	A LJ E K SJ E J <SPACE>
али	A LJ I <SPACE>
алина	A LJ I N EH <SPACE>
алиханаар	A LJ I H EH N AA R <SPACE>
алишье	A LJ I SH J EH <SPACE>
алтаар	A L T AA R <SPACE>
алтай	A L T EE <SPACE>
алтан	A L T EH NG <SPACE>
алтанхан	A L T EH N H EH NG <SPACE>
алташаһаа	A L T EH SH EH HH AA <SPACE>
алташынадагай	A L T EH SH Y N UUs D EH Gr EE <SPACE>
алха	A L H EH <SPACE>
алхам	A L H EH M <SPACE>
альга	A LJ G EH <SPACE>
альгаа	A LJ G AA <SPACE>
аман	A M EH NG <SPACE>
амараад	A M EH R AA T <SPACE>
амаралтада	A M EH R EH L T EH D EH <SPACE>
амаралтадаа	A M EH R EH L T EH D AA <SPACE>
амаралтын	A M EH R EH L T Y NG <SPACE>
амардагби	A M EH R D EH G BJ I <SPACE>
амаржа	A M EH R ZH EH <SPACE>
амбаар	A M B AA R <SPACE>
амжалта	A M ZH EH L T EH <SPACE>
амжалтатайгаар	A M ZH EH L T EH T EE Gr AA R <SPACE>
амидардаг	A MJ I D EH R D EH K <SPACE>
амидарна	A MJ I D EH R N EH <SPACE>
амилжа	A MJ I L ZH EH <SPACE>
амилхада	A MJ I L H EH D EH <SPACE>
амисхаалаар	A MJ I S H AA L AA R <SPACE>
амитад	A MJ I T EH T <SPACE>
амитан	A MJ I T EH NG <SPACE>
амтархан	A M T EH R H EH NG <SPACE>
амтатай	A M T EH T EE <SPACE>
амударья	A M Uh D A RJ J EH <SPACE>
анастасия	A N EH S T EH SJ I J A <SPACE>
ангарск	A N G A R S K <SPACE>
андреевна	A N D RJ E J E V N A <SPACE>
андрей	A N D RJ E J <SPACE>
анна	A N EH <SPACE>
ансамблиин	A N S A M B LJ II NG <SPACE>
ансамбль	A N S A M B LJ <SPACE>
ансамбльтаяа	A N S A M B LJ T A <SPACE>
антоновна	A N T O N O V N A <SPACE>
анужд	A N Uh ZH T <SPACE>
анха	A N H EH <SPACE>
анхан	A N H EH NG <SPACE>
анхарал	A N H EH R EH L <SPACE>
анхаралаа	A N H EH R EH L AA <SPACE>
анхаралаашье	A N H EH R EH L AA SH J EH <SPACE>
апокалипсиса	A P O Gr A LJ I P SJ I S A <SPACE>
арад	A R EH T <SPACE>
арадай	A R EH D EE <SPACE>
арадайнгаа	A R EH D EE NG AA <SPACE>
арадтаа	A R EH D T AA <SPACE>
арадтаяа	A R EH D T EH J AA <SPACE>
арадуудай	A R EH D UUh D EE <SPACE>
арадуудые	A R EH D UUh D Y J EH <SPACE>
арба	A R V EH <SPACE>
арбагархан	A R V EH Gr EH R H EH NG <SPACE>
арбадахи	A R V EH D EH HJ I <SPACE>
арбан	A R V EH NG <SPACE>
арга	A R Gr EH <SPACE>
аргаар	A R Gr AA R <SPACE>
аргагүй	A R Gr EH Gr UIs <SPACE>
аргагүйгөөр	A R Gr EH Gr UIs Gr OOs R <SPACE>
аргагүйдэнэб	A R Gr EH Gr UIs D EH NJ <SPACE>
аргалжа	A R Gr EH L ZH EH <SPACE>
аргамгүй	A R Gr EH M G UIs <SPACE>
аргануудые	A R Gr EH N UUh D Y J EH <SPACE>
аргатай	A R Gr EH T EE <SPACE>
аргатайб	A R Gr EH T EE P <SPACE>
аргатайл	A R Gr EH T EE L <SPACE>
аргын	A R Gr Y NG <SPACE>
арендэ	A RJ E N D EH <SPACE>
арсалааб	A R S EH L AA P <SPACE>
арсалан	A R S EH L EH NG <SPACE>
арсалановтан	A R S EH L A F T EH NG <SPACE>
арсаһан	A R S EH HH EH NG <SPACE>
артист	A R TJ I S T <SPACE>
артистка	A R TJ I S T N A <SPACE>
артистнар	A R TJ I S T N EH R <SPACE>
артистнарай	A R TJ I S T N EH R EE <SPACE>
артистнартай	A R TJ I S T N EH R T EE <SPACE>
артистын	A R TJ I S T Y NG <SPACE>
архи	A R HJ I <SPACE>
архида	A R HJ I D EH <SPACE>
архитекторнүүд	A R HJ I TJ EH K T O HJ I T <SPACE>
архитектурна	A R HJ I TJ EH K T Uh R N K T Uh R N K T Uh <SPACE>
аршаан	A R SH AA NG <SPACE>
аршаанда	A R SH AA N D EH <SPACE>
аршажа	A R SH EH ZH EH <SPACE>
арюун	A RJ UUh NG <SPACE>
арюунтай	A RJ UUh N T EH T EE <SPACE>
арһа	A R HH EH <SPACE>
асараа	A S EH R AA <SPACE>
асараад	A S EH R AA T <SPACE>
асарагдаһан	A S EH R EH G D EH HH EH NG <SPACE>
асарба	A S EH R V EH <SPACE>
асарбат	A S EH R V EH T <SPACE>
асуудал	A S UUh D EH L <SPACE>
асуудалнууд	A S UUh D EH L N UUh T <SPACE>
асуудалнуудни	A S UUh D EH L N UUh D NJ I <SPACE>
асуудалые	A S UUh D EH L Y J EH <SPACE>
асууһааб	A S UUh HH AA P <SPACE>
ася	A S J AA <SPACE>
атаархадаг	A T AA R H EH D EH K <SPACE>
афганай	A F G A N EE <SPACE>
афганистан	A F G A NJ I S T A N <SPACE>
афиша	A FJ I SH A <SPACE>
аха	A H EH <SPACE>
ахайе	A H EE J EH <SPACE>
аханарынь	A H EH N EH R Y NJ <SPACE>
ахань	A H EH NJ <SPACE>
аша	A SH EH <SPACE>
ашаар	A SH AA R <SPACE>
ашагдаһан	A SH EH G D EH HH AA NJ <SPACE>
ашада	A SH EH D EH <SPACE>
ашанар	A SH EH N EH R <SPACE>
ашанууднай	A SH EH N UUh D N EE <SPACE>
аюр	A J Uh R <SPACE>
аюрова	A J Uh R O V A <SPACE>
аюша	A J Uh SH A <SPACE>
аюшеевшье	A J Uh SH Uh J EH F SH J EH <SPACE>
аяар	A J AA R <SPACE>
аяга	A J A Gr A <SPACE>
аялга	A J A L Gr EH <SPACE>
аялгаар	A J A L Gr AA R <SPACE>
аялганууд	A J A L Gr EH N UUh T <SPACE>
аян	A J A NG <SPACE>
аяншалан	A J A SH N A L EH NG <SPACE>
аяншалга	A J EH N SH EH L Gr EH <SPACE>
аяншалгада	A J A SH N A G SH EH L Gr EH D EH <SPACE>
аяншалгашье	A J EH N SH J EH L Gr EH SH J EH <SPACE>
ба	B A <SPACE>
баабай	B AA V EE <SPACE>
баар	B AA R <SPACE>
баатай	B AA T EE <SPACE>
баатарнуудаараа	B AA T EH R N UUh D AA R AA <SPACE>
бабасановна	B A V EH S A N O V N A <SPACE>
бабур	B A V Uh R <SPACE>
бага	B A Gr EH <SPACE>
багаар	B A Gr AA R <SPACE>
багааршье	B A Gr AA R SH J EH <SPACE>
багадаа	B A Gr EH D AA <SPACE>
багадаашье	B A Gr EH D AA SH J EH <SPACE>
багадаев	B A Gr EH D A J EH F <SPACE>
багахан	B A Gr EH H EH NG <SPACE>
багаһаа	B A Gr EH HH AA <SPACE>
багсаагдана	B A G S AA G D EH N EH <SPACE>
багтаагүй	B A G T AA Gr UIs <SPACE>
багтаажа	B A G T AA ZH EH <SPACE>
багтаамжа	B A G T AA M ZH EH <SPACE>
багтаамжын	B A G T AA M ZH Y NG <SPACE>
багша	B A G SH EH <SPACE>
багшаар	B A K SH AA R <SPACE>
багшалнаб	B A G SH EH L N EH P <SPACE>
багшанар	B A K SH EH N EH R <SPACE>
багшанарай	B A K SH EH N EE R EE <SPACE>
багшанартай	B A K SH EH N EH R T EE <SPACE>
багшанарһаа	B A K SH EH N EH R HH AA <SPACE>
багшань	B A K SH EH NJ <SPACE>
бадаржа	B A D EH ZH EH <SPACE>
бадаруулһан	B A D EH R UUh L HH EH NG <SPACE>
бадлуев	B A D L J EH F <SPACE>
бадлуевай	B A D L J EH V EE <SPACE>
бадмацыбикова	B A D M A C Y VJ I K O V A <SPACE>
базар	B A Z EH R <SPACE>
базаргуруев	B A Z EH Gr Y J EH F <SPACE>
базаржапова	B A Z EH R ZH A P O V A <SPACE>
базаровна	B A Z A R O V N A <SPACE>
баир	B A J EH R <SPACE>
бай	B EE <SPACE>
байба	B EE V EH <SPACE>
байбал	B EE V EH L <SPACE>
байг	B EE Gr <SPACE>
байгаа	B EE Gr AA <SPACE>
байгааб	B EE Gr AA P <SPACE>
байгаагүй	B EE Gr AA Gr UIs <SPACE>
байгаагүйб	B EE Gr AA Gr UIs P <SPACE>
байгаад	B EE Gr AA T <SPACE>
байгаали	B EE Gr AA LJ I <SPACE>
байгаалидаа	B EE Gr AA LJ I D AA <SPACE>
байгаалиин	B EE Gr AA LJ II NG <SPACE>
байгаалитай	B EE Gr AA LJ I T EH <SPACE>
байгаалиһаа	B EE Gr AA LJ I HH AA <SPACE>
байгааш	B EE Gr AA SH <SPACE>
байгал	B EE Gr EH L <SPACE>
байгуулагданхай	B EE Gr UUh L EH G D EH N H EE <SPACE>
байгуулга	B EE Gr UUh L Gr EH <SPACE>
байгуулһан	B EE Gr UUh L HH EH NG <SPACE>
байдаг	B EE D EH K <SPACE>
байдагыень	B EE D EH Gr Y J EH NJ <SPACE>
байдал	B EE D EH L <SPACE>
байдалаар	B EE D EH L AA R <SPACE>
байдалаараашье	B EE D EH L AA R AA SH J EH <SPACE>
байдалай	B EE D EH L EE <SPACE>
байдалда	B EE D EH L D EH <SPACE>
байдалтай	B EE D EH L T EE <SPACE>
байдалыень	B EE D EH L Y J EH NJ <SPACE>
байжа	B EE ZH EH <SPACE>
байлсаатай	B EE L S AA T EE <SPACE>
байна	B EE N EH <SPACE>
байнаб	B EE N EH P <SPACE>
байнабди	B EE N EH B DJ I <SPACE>
байнабта	B EE N EH B T EH <SPACE>
байналши	B EE N EH L SH Y <SPACE>
байнат	B EE N EH T <SPACE>
байнхаар	B EE N H AA R <SPACE>
байра	B EE R EH <SPACE>
байраар	B EE R AA R <SPACE>
байтараа	B EE T EH R AA <SPACE>
байтарнай	B EE T EH R N EE <SPACE>
байхада	B EE H EH D EH <SPACE>
байхадаа	B EE H EH D AA <SPACE>
байхадам	B EE H EH D EH M <SPACE>
байхадань	B EE H EH D EH NJ <SPACE>
байхал	B EE H EH L <SPACE>
байхаш	B EE H EH SH <SPACE>
байхаяа	B EE H EH J AA <SPACE>
байхаһаа	B EE H EH HH AA <SPACE>
байхын	B EE H Y NG <SPACE>
байшан	B EE SH EH NG <SPACE>
байшанай	B EE SH EH N EE <SPACE>
байшангай	B EE SH EH N G EE <SPACE>
байшангуудые	B EE SH EH NG UUh D Y J EH <SPACE>
байшангүй	B EE SH EH N G UIs <SPACE>
байшанда	B EE SH EH N D EH <SPACE>
байшандамнай	B EE SH EH N D EH M N EE <SPACE>
байһан	B EE HH EH NG <SPACE>
байһанаа	B EE HH EH N AA <SPACE>
байһаниинь	B EE HH EH NJ II NJ <SPACE>
байһаншье	B EE HH EH NG SH J EH <SPACE>
байһые	B EE HH Y J EH <SPACE>
байһыень	B EE HH Y J EH NJ <SPACE>
балай	B A L EE <SPACE>
балбар	B A L V EH R <SPACE>
баледэй	B A LJ E D EE <SPACE>
балет	B A LJ E T <SPACE>
балетмейстер	B A LJ E T MJ E J A M S TJ E <SPACE>
балетнэ	B A LJ E T N EH <SPACE>
баллаар	B A L AA R <SPACE>
балтын	B A L T Y NG <SPACE>
балшар	B A L SH EH R <SPACE>
бальжинима	B A LJ ZH Y NJ I M EH <SPACE>
бальжинимаевна	B A LJ ZH Y NJ I M EH J EH V N A <SPACE>
бамба	B A M B EH <SPACE>
банзаровай	B A N Z A R O V EE <SPACE>
бар	B A R <SPACE>
бараандаа	B A R AA N D AA <SPACE>
баргажан	B A R Gr EH ZH EH NG <SPACE>
барилга	B A RJ I L Gr EH <SPACE>
барилгын	B A RJ I L Gr Y NG <SPACE>
барилдаагаар	B A RJ I L D AA Gr AA R <SPACE>
барилдаанай	B A RJ I L D AA N EE <SPACE>
барилдаашадай	B A RJ I L D AA N D EH D EE <SPACE>
барилдаашан	B A RJ I L D AA SH EH NG <SPACE>
баримта	B A RJ I M T EH <SPACE>
барисаата	B A RJ I S AA T EH <SPACE>
бариха	B A RJ I H EH <SPACE>
барихаш	B A RJ I H EH SH <SPACE>
барихаһаа	B A RJ I H EH HH AA <SPACE>
баруун	B A R UUh NG <SPACE>
бархируулһан	B A R HJ I R UUh L HH EH NG <SPACE>
баряа	B A RJ AA <SPACE>
басагад	B A S EH Gr EH T <SPACE>
басагадаараа	B A S EH Gr EH D AA R AA <SPACE>
басагадта	B A S EH Gr EH T T EH <SPACE>
басагадые	B A S EH Gr EH D Y J EH <SPACE>
басагадынь	B A S EH Gr EH D Y NJ <SPACE>
басагамни	B A S EH Gr EH M NJ I <SPACE>
басаган	B A S EH Gr EH NG <SPACE>
басаганиинь	B A S EH Gr EH NJ II NJ <SPACE>
басагантай	B A S EH Gr EH N T EE <SPACE>
басагань	B A S EH Gr EH NJ <SPACE>
басагаханай	B A S EH Gr EH H EH N EE <SPACE>
басагаяа	B A S EH Gr EH J AA <SPACE>
баскетболистнуудай	B A S EH T B O LJ I T EE T <SPACE>
бата	B A T EH <SPACE>
баталжа	B A T EH L ZH EH <SPACE>
бато	B A T EH <SPACE>
батожапов	B A T EH ZH A P O V <SPACE>
баторова	B A T EH R O V A <SPACE>
баясуулба	B A J A S UUh L V EH <SPACE>
баялиг	B A J A LJ I K <SPACE>
баялигууд	B A J A LJ I Gr UUh T <SPACE>
баялигые	B A J A LJ I Gr Y J EH <SPACE>
баян	B A J A NG <SPACE>
баянгаза	B A J A NG EH Z EH <SPACE>
баянгазада	B A J A NG EH Z EH D EH <SPACE>
баяр	B A J EH R <SPACE>
баяраа	B A J A R AA <SPACE>
баярай	B A J A R EE <SPACE>
баярлааб	B A J EH R L AA P <SPACE>
баярлаабди	B A J EH R L EH V AA R NJ I <SPACE>
баярта	B A J EH R T EH <SPACE>
баяртайб	B A J EH R T EE P <SPACE>
баяртайбди	B A J EH R T Y NJ I <SPACE>
баярто	B A J EH R T EH <SPACE>
баяртуевна	B A J EH R T Uh J E V N A <SPACE>
баярые	B A J EH R Y J EH <SPACE>
баясан	B A J A S EH NG <SPACE>
баясуулха	B A J A S UUh L H EH <SPACE>
баһа	B A HH EH <SPACE>
баһаа	B A HH AA <SPACE>
баһаашье	B A HH AA SH J EH <SPACE>
баһал	B A HH EH L <SPACE>
бекмамбетовэй	B E K M A M BJ E T O V EE <SPACE>
би	BJ I <SPACE>
библиотекарь	BJ I B LJ I O TJ E K EH RJ <SPACE>
библиотекын	BJ I B LJ I O TJ E K Y N <SPACE>
бидэ	BJ I D EH <SPACE>
бидэнтэеэ	BJ I D EH N T EH J EE <SPACE>
бидэнэй	BJ I D EH N EE <SPACE>
бии	BJ II <SPACE>
биибди	BJ II B DJ I <SPACE>
биил	BJ II L <SPACE>
билет	BJ II LJ E T <SPACE>
биолог	B O N O L Gr EH <SPACE>
бирагүйхэн	B I R EH Gr UIs H EH NG <SPACE>
бирма	BJ I R M EH <SPACE>
бишыхан	B I SH Y H EH NG <SPACE>
бишье	BJ II SH J EH <SPACE>
блогой	B L O Gr EE <SPACE>
блогоор	B L O Gr OOh R <SPACE>
богонихон	B O Gr EH NJ I H EH NG <SPACE>
бододог	B O D EH D EH K <SPACE>
бодол	B O D EH L <SPACE>
бодолгодо	B O D EH L Gr EH D EH <SPACE>
бодолдоо	B O D EH L D OOh <SPACE>
бодолнууд	B O D EH L N UUh T <SPACE>
бодолоор	B O D EH L OOh R <SPACE>
бодолтой	B O D EH L T EE <SPACE>
бодолые	B O D EH L Y J EH <SPACE>
бодонгууд	B O D EH N G UUh T <SPACE>
бодоод	B O D OOh T <SPACE>
бодото	B O D EH T EH <SPACE>
бодоходо	B O D EH H EH D EH <SPACE>
бодхоогоо	B O D H OOh Gr OOh <SPACE>
бодхоогоод	B O D H OOh Gr OOh T <SPACE>
болбосон	B O L V EH S EH NG <SPACE>
болбосоролдо	B O L V EH S EH R EH L D EH <SPACE>
болбосоролой	B O L V EH S EH R EH L EE <SPACE>
болгогдоо	B O L Gr EH G D OOh <SPACE>
болгогдоһон	B O L Gr EH G D EH HH EH NG <SPACE>
болгожо	B O L Gr EH ZH EH <SPACE>
болгохо	B O L Gr EH H EH <SPACE>
болгоһон	B O L Gr EH HH EH NG <SPACE>
болижо	B O LJ I ZH EH <SPACE>
болингүйгөөр	B O LJ I NG EH Gr UIs Gr OOs R <SPACE>
болобо	B O L EH V EH <SPACE>
болобол	B O L EH V EH L <SPACE>
болодог	B O L EH D EH K <SPACE>
боложо	B O L EH ZH EH <SPACE>
боложол	B O L EH ZH EH L <SPACE>
боломжонууд	B O L EH M ZH EH T <SPACE>
боломжонуудые	B O L EH M ZH EH N UUh D Y J EH <SPACE>
боломжотой	B O L EH M ZH EH T EE <SPACE>
боломоор	B O L EH M OOh R <SPACE>
болон	B O L EH NG <SPACE>
болоно	B O L EH N EH <SPACE>
болонолши	B O L EH N EH L SH Y <SPACE>
болонхой	B O L EH N H EE <SPACE>
болонхойб	B O L EH N H EE P <SPACE>
болонхойбди	B O L EH N H EE B DJ I <SPACE>
болоо	B O L OOh <SPACE>
болообди	B O L EH B DJ I <SPACE>
болоогүй	B O L OOh Gr UIs <SPACE>
болоод	B O L OOh T <SPACE>
болотор	B O L EH T EH R <SPACE>
болохо	B O L EH H EH <SPACE>
болохоб	B O L EH H EH P <SPACE>
болохогүй	B O L EH H EH Gr UIs <SPACE>
болохогүйнь	B O L EH H EH Gr UIs <SPACE>
болоходоо	B O L EH H EH D OOh <SPACE>
болохош	B O L EH H EH SH <SPACE>
болохынь	B O L EH H Y NJ <SPACE>
болошонхой	B O L EH SH EH N H EE <SPACE>
болошоо	B O L EH SH OOh <SPACE>
болошооб	B O L EH SH OOh P <SPACE>
болошоод	B O L EH SH OOh T <SPACE>
болоһон	B O L EH HH EH NG <SPACE>
болоһоншье	B O L EH HH EH NG SH J EH <SPACE>
болоһоор	B O L EH HH OOh R <SPACE>
болоһыень	B O L EH HH Y J EH NJ <SPACE>
болхоева	B O L H O J EH V A <SPACE>
большой	B O LJ M EE <SPACE>
боом	B OOh M <SPACE>
борбилоо	B O R VJ I L OOh <SPACE>
борголовтоной	B O R Gr EH L EH F T EH N EE <SPACE>
борис	B O RJ I S <SPACE>
борисович	B O RJ I S O VJ I CH <SPACE>
борисовна	B O RJ I S O V N A <SPACE>
борисовтай	B O RJ I S O F T EE <SPACE>
боро	B O R EH <SPACE>
бороо	B O R OOh <SPACE>
бороотой	B O R OOh T EE <SPACE>
будаина	B Uh D A I N A <SPACE>
будда	B Uh D D EH <SPACE>
буддизм	B Uh DJ I Z M <SPACE>
буддын	B Uh D EH N UUs NG <SPACE>
будущего	B Uh D Uh SCH E V Gr EH <SPACE>
бузинаева	B Uh ZJ I N A J EH V A <SPACE>
бузинаевагай	B Uh ZJ I N A J E V A Gr EE <SPACE>
буйлуулаа	B UIh L UUh L AA <SPACE>
буйлуулдаг	B UIh L UUh L D EH K <SPACE>
булаг	B Uh L EH G <SPACE>
булагай	B Uh L EH Gr EE <SPACE>
булагууд	B Uh L EH Gr UUh T <SPACE>
булагһаань	B Uh L EH G HH AA NJ <SPACE>
булад	B Uh L EH T <SPACE>
буладай	B Uh L EH D EE <SPACE>
булат	B Uh L EH T <SPACE>
булгилһан	B Uh L GJ I L HH EH NG <SPACE>
булта	B Uh L T EH <SPACE>
бултадаа	B Uh L T EH D AA <SPACE>
бултал	B Uh L T EH L <SPACE>
бултанайнгаа	B Uh L T EH N EE NG AA <SPACE>
бултанииемнай	B Uh L T EH NJ II J EH M N EE <SPACE>
бултыемнай	B Uh L T Y J EH M N EE <SPACE>
буляалдалгын	B Uh LJ A L D EH L Gr Y N UUs NG <SPACE>
бурхад	B Uh R H EH T <SPACE>
бурхан	B Uh R H EH NG <SPACE>
бурханай	B Uh R H EH N EE <SPACE>
бурхандаа	B Uh R H EH N D AA <SPACE>
буряад	B Uh RJ AA T <SPACE>
буряадаар	B Uh RJ AA D AA R <SPACE>
буряадаараа	B Uh RJ AA D AA R AA <SPACE>
буряадай	B Uh RJ AA D EE <SPACE>
буряадаймнай	B Uh RJ AA D EE M N EE <SPACE>
буряадууд	B Uh RJ AA D UUh T <SPACE>
буряадуудай	B Uh RJ AA D UUh D EE <SPACE>
буряадуудбди	B Uh RJ AA D UUh D B DJ I <SPACE>
бурятия	B Uh RJ A TJ I J A <SPACE>
буряяадууд	B Uh RJ AA D UUh T <SPACE>
бусааха	B Uh S AA H EH <SPACE>
бусад	B Uh S EH T <SPACE>
бусадшье	B Uh S EH D SH J EH <SPACE>
бусадһаа	B Uh S EH D HH AA <SPACE>
бусажа	B Uh S EH ZH EH <SPACE>
бусалжа	B Uh S EH L ZH EH <SPACE>
бусаха	B Uh S EH H EH <SPACE>
бусахань	B Uh S EH H EH NJ <SPACE>
бусашаһан	B Uh S EH SH EH HH EH NG <SPACE>
бута	B Uh T EH <SPACE>
буудажархеоб	B UUh D EH ZH EH R HJ OOh P <SPACE>
буудажархёоб	B UUh D EH ZH EH R HJ OOh P <SPACE>
буулгагша	B UUh L Gr EH G SH EH <SPACE>
буулгадаг	B UUh L Gr EH D EH K <SPACE>
буулгажа	B UUh L Gr EH ZH EH <SPACE>
буулгаха	B UUh L Gr EH H EH <SPACE>
буулгахада	B UUh L Gr EH H EH D EH <SPACE>
буулгаһан	B UUh L Gr EH HH EH NG <SPACE>
буулгуулдаг	B UUh L Gr UUh L D EH K <SPACE>
буусада	B UUh S EH D EH <SPACE>
бууһан	B UUh HH EH NG <SPACE>
бухгалтер	B Uh H EH L T EH R <SPACE>
бухы	B Uh H Y <SPACE>
буянгаар	B Uh J EH N G AA R <SPACE>
бшуу	B SH UUh <SPACE>
бэ	B E <SPACE>
бэдэрдэг	B E D EH R D EH K <SPACE>
бэдэрхэдэнь	B E D EH R H EH D EH NJ <SPACE>
бэдэрхэеэ	B E D EH R H EH J EE <SPACE>
бэе	B E J EH <SPACE>
бэедэ	B E J EH D EH <SPACE>
бэедэшье	B E J EH D EH SH J EH <SPACE>
бэедээ	B E J EH D EE <SPACE>
бэелүүлсэһэн	B E J EH L UUs L HH EH NG <SPACE>
бэелүүлхын	B E J EH L UUs L H Y NG <SPACE>
бэелүүлхэ	B E J EH L UUs L H EH <SPACE>
бэелүүлхэеэ	B E J EH L UUs L H EH J EE <SPACE>
бэелүүлэгдэхэ	B E J EH L UUs L EH G D EH H EH <SPACE>
бэелүүлэлсэһэн	B E J EH L UUs L EH HH EH L HH EH NG <SPACE>
бэетэй	B E J EH T EE <SPACE>
бэеын	B E J Y NG <SPACE>
бэеынгээ	B E J Y NG G EE <SPACE>
бэеэ	B E J EE <SPACE>
бэзэ	B E Z EH <SPACE>
бэлдэгшэд	B E L D EH G SH J EH <SPACE>
бэлдээтэй	B E L D EE T EE <SPACE>
бэлдэһэн	B E L D EH HH EH NG <SPACE>
бэлиг	B E LJ I K <SPACE>
бэлигтэй	B E LJ I K T EE <SPACE>
бэлигэй	B E LJ I Gr EE <SPACE>
бэлигээ	B E LJ I Gr EE <SPACE>
бэлшээринүүднай	B E L SH EH RJ I N UUs D EE <SPACE>
бэлшээритэй	B E L SH EH RJ I T EE <SPACE>
бэлшээриһээ	B E L SH EH RJ I HH EE <SPACE>
бэлэг	B E L EH K <SPACE>
бэлэглээ	B E L EH G L EE <SPACE>
бэлэглэһэн	B E L EH G L EH HH EH NG <SPACE>
бэлэгүүд	B E L EH Gr UUs T <SPACE>
бэлэй	B E L EE <SPACE>
бэлэйбди	B E L EE B DJ I <SPACE>
бэлэн	B E L EH NG <SPACE>
бэрхэ	B E R H EH <SPACE>
бэрхэтэй	B E R H EH T EE <SPACE>
бэрхэшээлнүүд	B E R H EH SH EE L N UUs T <SPACE>
бэрхэшээлнүүдһээ	B E R H EH SH EE L N UUs D HH EE <SPACE>
бэшэ	B E SH EH <SPACE>
бэшэб	B E SH EH P <SPACE>
бэшэгдэһэн	B E SH EH G D EH HH EH NG <SPACE>
бэшэгэй	B E SH EH Gr EE <SPACE>
бэшэгүүд	B E SH EH Gr UUs T <SPACE>
бэшэжэ	B E SH EH ZH EH <SPACE>
бэшэжэрхидэг	B E SH EH ZH EH R HJ I D EH K <SPACE>
бэшэн	B E SH EH NG <SPACE>
бэшэшье	B E SH EH SH J EH <SPACE>
бэшээ	B E SH EE <SPACE>
бэшүүрэй	B E SH EH R EE <SPACE>
бүгэдые	B Us Gr EH D Y J EH <SPACE>
бүгэдэ	B Us Gr EH D EH <SPACE>
бүлгэм	B Us L Gr EH M <SPACE>
бүлын	B Us L Y NG <SPACE>
бүлынгөө	B Us L Y NG G OOs <SPACE>
бүлэ	B Us L EH <SPACE>
бүлэг	B Us L EH K <SPACE>
бүлэгтэ	B Us L EH G T EH <SPACE>
бүлэгтэеэ	B Us L EH G T EH J EE <SPACE>
бүлэгынь	B Us L EH Gr Y NJ <SPACE>
бүлэгэй	B Us L EH Gr EE <SPACE>
бүлэдэ	B Us L EH D EH <SPACE>
бүлэмни	B Us L EH M NJ I <SPACE>
бүри	B Us RJ I <SPACE>
бүридхэмэл	B Us RJ I R H EH M EH L <SPACE>
бүридэһэн	B Us RJ I D EH HH EH NG <SPACE>
бүридүүлэгдэһэн	B Us RJ I D UUs L EH G D EH HH EH NG <SPACE>
бүтэдэг	B Us T EH D EH K <SPACE>
бүтээгдэнхэй	B Us T EE G D EH N H EE <SPACE>
бүтээгээд	B Us T EE Gr EE T <SPACE>
бүтээлнүүдые	B Us T EE L N UUs D Y J EH <SPACE>
бүтээлнүүдээрээ	B Us T EE L N UUs D EE R EE <SPACE>
бүтээлэй	B Us T EE L EE <SPACE>
бүтээхэеэ	B Us T EE H EH J EE <SPACE>
бүтээһэн	B Us T EE HH EH NG <SPACE>
бүхы	B Us H Y <SPACE>
бүхыдэнь	B Us H Y D EH NJ <SPACE>
бүхыдөө	B Us H Y D OOs <SPACE>
бүхые	B Us H Y J EH <SPACE>
бүхэдэлхэйн	B Us H EH D EH L H EE NG <SPACE>
бүхэн	B Us H EH NG <SPACE>
бүхэндэ	B Us H EH N D EH <SPACE>
бүхэниие	B Us H EH NJ II J EH <SPACE>
бүхэниинь	B Us H EH NJ II NJ <SPACE>
бүхэнэй	B Us H EH N EE <SPACE>
бүүбэйнүүд	B UUs V EE N UUs T <SPACE>
бүһэтэй	B Us HH EH T EE <SPACE>
бөө	B OOs <SPACE>
вазын	V A Z Y NG <SPACE>
валентина	V A LJ E N TJ I N T EH <SPACE>
валерий	V A LJ E RJ I J <SPACE>
валерьевна	V A LJ E RJ J E V N A <SPACE>
валиджан	V A LJ I D ZH A NG <SPACE>
вениамин	VJ E NJ I A MJ I NG <SPACE>
вера	VJ E R EH <SPACE>
вероника	VJ E R O NJ I K EH <SPACE>
ветеран	VJ E TJ E R A NG <SPACE>
ветеринар	VJ E TJ E RJ I N A R A <SPACE>
видеоролик	VJ DJ E O R O LJ I K <SPACE>
винчиин	VJ I N CH II NG <SPACE>
виртаненэй	VJ I R T A NJ EH N EE <SPACE>
владимир	V L A DJ I M I R <SPACE>
выставкэ	V Y S T A F K EH <SPACE>
вьетнам	VJ E T N A M <SPACE>
вячеслав	VJ A CH E S A L V A <SPACE>
габаһаа	G A V EH HH AA <SPACE>
габьяа	G A VJ J AA <SPACE>
габьяата	G A VJ J AA T EH <SPACE>
габьяатай	G A VJ J AA T EE <SPACE>
гавриловна	G A V RJ I L O V A <SPACE>
гадаада	G A D AA D EH <SPACE>
гадна	G A D N EH <SPACE>
газаа	G A Z AA <SPACE>
газаашаа	G A Z AA SH AA <SPACE>
газар	G A Z EH R <SPACE>
газараа	G A Z EH R AA <SPACE>
газарай	G A Z EH R EE <SPACE>
газарнай	G A Z EH R EE <SPACE>
газарнууд	G A Z EH R N UUh T <SPACE>
газарнууднай	G A Z EH R N UUh D N EE <SPACE>
газарнуудта	G A Z EH R N UUh T T EH <SPACE>
газарта	G A Z EH R T EH <SPACE>
газартаа	G A Z EH R T AA <SPACE>
газартань	G A Z EH R T EH NJ <SPACE>
гайтай	G EE T EE <SPACE>
гайхаа	G EE H AA <SPACE>
гайхааб	G EE H AA P <SPACE>
гайхалтай	G EE H EH L T EE <SPACE>
гайхамшагта	G EE H EH M SH EH T K EH <SPACE>
гайхуулаа	G EE H UUh L AA <SPACE>
гал	G A L <SPACE>
галерей	G A LJ E RJ J EH <SPACE>
галнууд	G A L N UUh D <SPACE>
ганса	G A N S EH <SPACE>
гансал	G A N S EH L <SPACE>
гансалтайхан	G A N S EH L T EE H EH NG <SPACE>
гансам	G A N S EH M <SPACE>
гансахан	G A N S EH H EH NG <SPACE>
гансашье	G A N S EH SH J EH <SPACE>
гар	G A R <SPACE>
гараа	G A R AA <SPACE>
гараад	G A R AA T <SPACE>
гарагшад	G A R EH G SH EH T <SPACE>
гарадаг	G A R EH D EH K <SPACE>
гарадаггүй	G A R EH D EH Gr UIs <SPACE>
гаража	G A R EH ZH EH <SPACE>
гаралхидни	G A R EH L HJ I D NJ I <SPACE>
гаран	G A R EH NG <SPACE>
гаранхай	G A R EH NG H EE <SPACE>
гаратараа	G A R EH T EH R AA <SPACE>
гараха	G A R EH H EH <SPACE>
гарахаар	G A R EH H AA R <SPACE>
гарахаб	G A R EH H EH P <SPACE>
гарашаба	G A R EH SH EH V EH <SPACE>
гарашооб	G A R EH SH OOh P <SPACE>
гараһан	G A R EH HH EH NG <SPACE>
гарбал	G A R V EH L <SPACE>
гарбалтай	G A R V EH L T EE <SPACE>
гарбалтанай	G A R V EH L T EH N EE <SPACE>
гарбалынь	G A R V EH L Y NJ <SPACE>
гаргаа	G A R Gr AA <SPACE>
гаргааб	G A R Gr AA P <SPACE>
гаргадаггүй	G A R Gr EH D EH Gr UIs <SPACE>
гарганхай	G A R EH N H EE <SPACE>
гаргашалагдадаг	G A R Gr EH SH EH L D EH G D EH G <SPACE>
гарни	G A R N GJ I <SPACE>
гастрольдо	G A S EH R B LJ L EH <SPACE>
гатыповнагай	G A T Y P O V N EE <SPACE>
гаутамаарүндэһэлһэн	G A Us T A M AA R Us N D EH HH EH L HH EH NG <SPACE>
гашей	G A SH EE <SPACE>
гашейн	G A SH EE NG <SPACE>
герируд	GJ E RJ I R Uh T <SPACE>
германиин	GJ E R M A NJ II NG <SPACE>
герой	GJ E R O J <SPACE>
гильменд	GJ I LJ M E N D NG <SPACE>
гималайн	GJ I M A L EE NG <SPACE>
гимназиин	GJ I M N A ZJ II NG <SPACE>
гитис	GJ I TJ I S <SPACE>
гоелто	G O J EH L T EH <SPACE>
гоеор	G O J OOh R <SPACE>
гол	G O L <SPACE>
голливудта	G O LJ I V Uh J I L D T AA <SPACE>
гомбо	G O M B EH <SPACE>
гомдол	G O M D EH L <SPACE>
гонзогорхон	G O N Z EH G H EH R H EH NG <SPACE>
гончикова	G O N CH I K O V A <SPACE>
горитойхон	G O RJ I T EE H EH NG <SPACE>
городто	G O R EH T T EH <SPACE>
горского	G O R S O RJ S K O V O <SPACE>
гостелерадиокомпани	G O S TJ E LJ E R A DJ I O <SPACE>
гоё	G O J EH <SPACE>
гоёор	G O J OOh R <SPACE>
гоёшоодог	G O J EH SH OOh D EH K <SPACE>
градус	G R A D Uh S <SPACE>
грамм	G R A M <SPACE>
гранпри	G R A N P RJ I <SPACE>
графика	G R A FJ I K EH <SPACE>
григорий	G Uh RJ I RJ I <SPACE>
григорьевна	G RJ I K Uh R J E V N A <SPACE>
гуйлаа	G UIh L AA <SPACE>
гуйлтыень	G UIh L T Y J EH NJ <SPACE>
гуйһан	G UIh HH EH NG <SPACE>
гуламта	G Uh L EH M T EH <SPACE>
гунхуулхагүй	G Uh N H UUh L H EH D UIs <SPACE>
гурба	G Uh R V EH <SPACE>
гурбадахи	G Uh R V EH D EH HJ I <SPACE>
гурбан	G Uh R V EH NG <SPACE>
гурбанһаа	G Uh R V EH N HH AA <SPACE>
гурбатайһаань	G Uh R V EH T EE HH AA NJ <SPACE>
гурбахан	G Uh R V EH H EH NG <SPACE>
гурэнэй	G Uh R EH N EE <SPACE>
гусиноозерск	G Uh SJ I N O ZJ OOh R <SPACE>
гутал	G Uh T EH L <SPACE>
гутаповна	G Uh T A P O V N A <SPACE>
гушанартай	G Uh SH EH N EH R T EE <SPACE>
гэбэл	G E V EH L <SPACE>
гэбэшье	G E V EH SH J EH <SPACE>
гэгшын	G E G SH Y NG <SPACE>
гэгшэд	G E G SH EH D <SPACE>
гэгшэдэй	G E G SH EH D EE <SPACE>
гэдэг	G E D EH K <SPACE>
гэдэргээ	G E D EH R Gr EE Gr EE <SPACE>
гэжэ	G E ZH E <SPACE>
гэжэшье	G E ZH E J EH <SPACE>
гэлдэнэбди	G E L D EH N EH <SPACE>
гэлсэдэг	G E L S EH D EH K <SPACE>
гэлсээбди	G E L S EE B DJ I <SPACE>
гэмэ	G E M EH <SPACE>
гэн	G O NG <SPACE>
гэнтэ	G E N T EH <SPACE>
гэнэ	G E N EH <SPACE>
гэр	G EH R <SPACE>
гэрнүүд	G EH R N UUs T <SPACE>
гэртэ	G EH R T EH <SPACE>
гэртэй	G EH R T EE <SPACE>
гэртэнь	G EH R T EH NJ <SPACE>
гэртэхиндэнь	G EH R T EH HJ I N D EH NJ <SPACE>
гэртэхиндээшье	G EH R T EH HJ I N D EE SH J EH SH EE SH J EH <SPACE>
гэртэхиншье	G EH R T EH HJ I N NJ I J EH NJ <SPACE>
гэртэхинэй	G EH R T EH HJ I N EE <SPACE>
гэртэхинэйнгээ	G EH R T EH HJ I N EE NG G EE <SPACE>
гэртэхинээ	G EH R T EH HJ I N EE <SPACE>
гэртээ	G EH R T EE <SPACE>
гэршэлбэ	G EH R SH EH L V EH <SPACE>
гэршэлгэнүүд	G EH R SH EH L Gr UUs N D EH N UUs T <SPACE>
гэршэлдэг	G EH R SH EH L D EH K <SPACE>
гэршэлэн	G EH R SH EH L EH NG <SPACE>
гэршэлээ	G EH R SH EH L EE <SPACE>
гэрэй	G EH R EE <SPACE>
гэрэйнгээ	G EH R EE NG G EE <SPACE>
гэрэйхи	G EH R EE HJ I <SPACE>
гэрэл	G EH R EH L <SPACE>
гэрэлтэ	G EH R EH L T EH <SPACE>
гэрээшье	G EH R EE SH J EH <SPACE>
гэхэ	G E H EH <SPACE>
гэхэдэ	G E H EH D EE <SPACE>
гэхэдэнь	G E H EH D EH NJ <SPACE>
гэхэдээ	G E H EH D EE <SPACE>
гэшүүн	G E SH UUs NG <SPACE>
гээ	G EE <SPACE>
гээбы	G EE V Y <SPACE>
гээд	G EE T <SPACE>
гээшье	G EE SH J EH <SPACE>
гээшэ	G EE SH EE <SPACE>
гээшэб	G EE SH EH P <SPACE>
гээшэбибди	G EE SH EH VJ I B DJ I <SPACE>
гээшэбииб	G EE SH E VJ II P <SPACE>
гээшэбта	G EE SH EH P T EH <SPACE>
гээшэмнай	G EE SH EH M N EE <SPACE>
гэһэн	G E HH EH NG <SPACE>
гэһэндэл	G E HH EH N D EH L <SPACE>
гэһээмни	G E HH EE M NJ I <SPACE>
гү	G Us <SPACE>
гүйгээб	G UIs Gr EE P <SPACE>
гүйдэлтэйгөөр	G UIs D EH L T EE Gr OOs R <SPACE>
гүйжэ	G UIs ZH EH <SPACE>
гүйсэдхэдэг	G UIs S EH T H EH D EH G <SPACE>
гүйсэдхэжэ	G UIs S EH T H EH ZH EH <SPACE>
гүйсэдхэнэ	G UIs S EH T H EH N EH <SPACE>
гүйсэдхэхэдэ	G UIs S EH T H EH H EH D EE <SPACE>
гүйсэдхэһэн	G UIs S EH T H EH HH EE NG <SPACE>
гүлмэрхэн	G Us L M EH R V EH NG <SPACE>
гүн	G Us NG <SPACE>
гүнзэгы	G Us N Z EH Gr Y <SPACE>
гүнзэгыгөөр	G Us N Z EH Gr Y Gr OOs R <SPACE>
гүнзэгырүүлээб	G N UUs HH EH R Y J EH L EE P <SPACE>
гүрэн	G Us R EH NG <SPACE>
гүрэндэ	G Us R EH N D EH <SPACE>
гүрэнэй	G Us R EH N EE <SPACE>
гүрэнүүдэй	G Us R EH N UUs D EE <SPACE>
гүү	G UUs <SPACE>
гүүлэжэрхидэг	G UUs L EH ZH E R HJ I D EH K <SPACE>
гүүртэнүүдэй	G UUs R T EH N UUs D EE <SPACE>
да	D A <SPACE>
даа	D AA <SPACE>
даагша	D AA G SH EH <SPACE>
даамай	D AA M EE <SPACE>
даб	D A P <SPACE>
даба	D A V EH <SPACE>
дабажа	D A ZH EH <SPACE>
дабашагүй	D A V EH SH EH Gr UIs <SPACE>
дабтагдадаг	D A P T EH G D EH D EH K <SPACE>
дабтагдадагшье	D A P G EH D EH G D EH D EH Gr UIs <SPACE>
дабтажал	D A P T EH ZH EH L <SPACE>
дабтамаар	D A P T EH M AA R <SPACE>
дабташагүй	D A P T AA SH EH Gr UIs <SPACE>
дагаева	D A Gr A J EH V A <SPACE>
дай	D EE <SPACE>
дайда	D EE D EH <SPACE>
дайдаар	D EE D AA R <SPACE>
дайдада	D EE D EH D EH <SPACE>
дайдань	D EE D EH NJ <SPACE>
дайдаяа	D EE D EH J AA <SPACE>
дайдынгаа	D EE D Y NG G AA <SPACE>
дайнай	D EE N EE <SPACE>
дайралдаа	D EE R EH L D AA <SPACE>
дайралдадаг	D EE R EH L D EH D EH K <SPACE>
дайралдаһан	D EE R EH L D EH HH EH NG <SPACE>
дайралсадаг	D EE R EH L S EH D EH K <SPACE>
дайраха	D EE R EH H EH <SPACE>
дайшалхы	D EE SH EH L H Y <SPACE>
далаад	D A L AA T <SPACE>
далайгаа	D A L EE Gr AA <SPACE>
далайдаа	D A L EE D AA <SPACE>
далаймни	D A L EE M NJ I <SPACE>
далайн	D A L EE NG <SPACE>
далайһаашье	D A L EE HH AA SH J EH <SPACE>
далан	D A L EH NG <SPACE>
далахай	D A L EH H EE <SPACE>
далахаймни	D A L EH H EE M NJ I <SPACE>
далахайн	D A L EH H EE NG <SPACE>
далбаева	D A L V A J EH V A <SPACE>
далбаевтай	D A L V A J EH F T EH T EE <SPACE>
далбаевтан	D A L V A J EH F T EH T EH NJ <SPACE>
дали	D A LJ I <SPACE>
даллан	D A L EH NG <SPACE>
дамба	D A M B EH <SPACE>
дамдинов	D A M DJ I N O V <SPACE>
дамдиновагай	D A M DJ I N O V A Gr EE <SPACE>
дамдиновна	D A M DJ I N O V A <SPACE>
дамжуулагдаа	D A M ZH UUh L Gr AA G D AA <SPACE>
дамжуулагдаһан	D A M ZH UUh L EH G D EH HH EH NG <SPACE>
дамжуулдаг	D A M ZH UUh L D EH K <SPACE>
дамжуулха	D A M ZH UUh L H EH <SPACE>
дамжуулһан	D A M ZH UUh L HH EH NG <SPACE>
дангина	D A N GJ I N EH <SPACE>
дангинанаараа	D A N GJ I N EH N AA R AA <SPACE>
дандар	D A N D EH R <SPACE>
дансануудаа	D A N S EH N UUh D AA <SPACE>
дансаранов	D A N S A R O V O F <SPACE>
дарга	D A R Gr EH <SPACE>
дари	D A RJ I <SPACE>
дарима	D A RJ I M A <SPACE>
дармаев	D A R M A J EH F <SPACE>
дармаевтанайнгаа	D A R M A J EH F T EH N EE NG AA <SPACE>
даруу	D A R Uh <SPACE>
даруулаагүй	D A R UUh L AA Gr UIs <SPACE>
дасан	D A S EH NG <SPACE>
дасанай	D A S EH N EE <SPACE>
дасангууд	D A S EH N G UUh T <SPACE>
дасанда	D A S EH N D EH <SPACE>
дахажа	D A H EH ZH EH <SPACE>
дахин	D A HJ I NG <SPACE>
дахуулаад	D A L UUh L AA T <SPACE>
дахуулха	D A H UUh L H EH <SPACE>
дахяад	D A HJ AA T <SPACE>
дашарамдуулан	D A SH EH R EH M D UUh L EH NG <SPACE>
дашиевич	D A SH Y J O VJ I CH <SPACE>
даяар	D A J AA R <SPACE>
декабриин	DJ E K A P RJ II NJ <SPACE>
декадада	DJ E K A D EH D EH <SPACE>
джон	D ZH O NG <SPACE>
диилэнхи	DJ II L EH N H I <SPACE>
диилэнэ	DJ II L EH N EH <SPACE>
диилээ	DJ II L EE <SPACE>
директор	DJ I RJ E K T O R <SPACE>
добтолгоһоо	D O P T EH L Gr O HH OOh <SPACE>
долгилхые	D O L GJ I L H Y J EH <SPACE>
долгито	D O L GJ I T EH <SPACE>
должон	D O L ZH EH NG <SPACE>
долоогоно	D O L OOh Gr EH N EH <SPACE>
долоон	D O L OOh NG <SPACE>
домог	D O M EH K <SPACE>
домто	D O M T EH <SPACE>
дон	D O NG <SPACE>
дондок	D O N D EH K <SPACE>
дондокович	D O N D EH K O V I CH <SPACE>
донна	D O N EH <SPACE>
доогуур	D OOh Gr EH R <SPACE>
доодо	D OOh D EH <SPACE>
доржо	D O R ZH EH <SPACE>
доро	D O R EH <SPACE>
доройтолго	D O R EE T EH L Gr EH <SPACE>
дороо	D O R OOh <SPACE>
дороһоо	D O R EH HH OOh <SPACE>
досоо	D O S OOh <SPACE>
досоомни	D O S OOh M NJ I <SPACE>
дотор	D O T EH R <SPACE>
доторой	D O T EH R EE <SPACE>
доторойнгоо	D O T EH R EE NG AA <SPACE>
дохин	D O HJ I NG <SPACE>
дошхон	D O SH H EH NG <SPACE>
доһолгоно	D O HH EH L Gr EH N EH <SPACE>
доһолоод	D O HH EH L OOh T <SPACE>
драмын	D R A M Y NG <SPACE>
дугы	D Uh Gr Y <SPACE>
дулаан	D Uh L AA NG <SPACE>
дулаахан	D Uh L AA H EH NG <SPACE>
дулааханаар	D Uh L AA H AA R <SPACE>
дулдыдана	D Uh L D Y D EH N EH <SPACE>
дулма	D Uh L M EH <SPACE>
дулмаһаа	D Uh L M A HH AA <SPACE>
дунда	D Uh N D EH <SPACE>
дундажа	D Uh N D EH ZH EH <SPACE>
дундаршагүй	D Us N D EH R SH EH Gr UIs <SPACE>
дураар	D Uh R AA R <SPACE>
дураараа	D Uh R AA R AA <SPACE>
дурадхагдаһан	D Uh R EH T H EH G D EH HH E NG <SPACE>
дурадхалнууд	D Uh R EH T H EH L N UUh T <SPACE>
дурадхаһан	D Uh R EH T H EH HH EH NG <SPACE>
дуран	D Uh R EH NG <SPACE>
дуранай	D Uh R EH N EE <SPACE>
дурасхаалай	D Uh R EH S H AA L EE <SPACE>
дуратай	D Uh R EH T EE <SPACE>
дуратайб	D Uh R EH T EE P <SPACE>
дуратайгаар	D Uh R EH T EE Gr AA R <SPACE>
дуратайл	D Uh R EH T EE L <SPACE>
дурданабди	D Uh R D EH N EH B DJ I <SPACE>
дурдая	D Uh R D EH J AA <SPACE>
дурлаһан	D Uh R L EH HH EH NG <SPACE>
дурлуулһан	D Uh R L UUh L HH EH NG <SPACE>
дуталдахада	D Uh T EH L D EH D EH <SPACE>
дутуу	D Uh T UUh <SPACE>
дутуугүй	D Uh T UUh Gr UIs <SPACE>
дуу	D UUh <SPACE>
дуугай	D UUh Gr EE <SPACE>
дуугаргажа	D UUh Gr EH R Gr EH ZH EH <SPACE>
дуугардаг	D UUh Gr EH R D EH K <SPACE>
дуугарха	D UUh Gr EH R H EH <SPACE>
дуулааб	D UUh L AA P <SPACE>
дууладаг	D UUh L EH D EH K <SPACE>
дуулажа	D UUh L EH ZH EH <SPACE>
дуулалдаа	D UUh L EH L D AA <SPACE>
дуулан	D UUh L EH NG <SPACE>
дуулана	D UUh L EH N EH <SPACE>
дууланалби	D UUh L EH N EH L VJ I <SPACE>
дуулдана	D UUh L D EH N EH <SPACE>
дуунууд	D UUh N UUh T <SPACE>
дуунуудаа	D UUh N UUh D AA <SPACE>
дуунуудые	D UUh N UUh D Y J EH <SPACE>
дуутай	D UUh T EE <SPACE>
дууша	D UUh SH AA <SPACE>
дуушад	D UUh SH EH T <SPACE>
дуушан	D UUh SH EH NG <SPACE>
дууһаад	D UUh HH AA T <SPACE>
дууһаха	D UUh HH EH H EH <SPACE>
дуһаажа	D Uh HH AA ZH EH <SPACE>
дэбисхэр	D E VJ I S H EH R <SPACE>
дэбтэрнүүд	D E B T EH R N UUs T <SPACE>
дэгэл	D E Gr EH L <SPACE>
дэгэлтэй	D E Gr EH L T EE <SPACE>
дэлгэбэ	D E L Gr EH V EH <SPACE>
дэлгэн	D E L Gr EH NG <SPACE>
дэлгэнхэй	D E L Gr EH N H EE <SPACE>
дэлгэрдэг	D E L Gr EH R D EH K <SPACE>
дэлгэрнэ	D E L Gr EH R N EH <SPACE>
дэлгэрүүлэгдэбэ	D E L Gr EH R UUs L EH G D EH V EH <SPACE>
дэлгээгдэнхэй	D E L Gr EE G D EH N H EE <SPACE>
дэлгээд	D E L Gr EE D <SPACE>
дэлгэһэн	D E L Gr EH HH EH NG <SPACE>
дэлгүүрнүүдэй	D E L Gr UUs R N UUs D EE <SPACE>
дэлхэй	D E L H EE <SPACE>
дэлхэйгээр	D E L H EE Gr EE R <SPACE>
дэлхэйгээршье	D E L H EE Gr EE R SH J EH <SPACE>
дэлхэйдэ	D E L H EE D EH <SPACE>
дэлхэйдээрэ	D E L H EE D EE R EH <SPACE>
дэлхэйе	D E L H EE J EH <SPACE>
дэлхэйн	D E L H EE NG <SPACE>
дэмбэрэлтэй	D E M B EH R EH L T EE <SPACE>
дэмжэдэг	D E M ZH EH D EH K <SPACE>
дэмжэлгэнь	D E M ZH EH L Gr EH NJ <SPACE>
дэмжэлгэһээ	D E M ZH EH L Gr EH HH EE <SPACE>
дэргэдэ	D E R Gr EH D EH <SPACE>
дээгүүр	D EE Gr UUs R <SPACE>
дээдын	D EE D Y NG <SPACE>
дээдэ	D EE D EH <SPACE>
дээрэ	D EE R EH <SPACE>
дээрэнь	D EE R EH NJ <SPACE>
дээрээ	D EE R EE <SPACE>
дээрэһээнь	D EE R EH HH EE NJ <SPACE>
дээшэн	D EE SH EH NG <SPACE>
дээшэнь	D EE SH EH NJ <SPACE>
дээшээ	D EE SH EE <SPACE>
дүй	D UIs <SPACE>
дүлөөр	D Us L OOs R <SPACE>
дүн	D Us NG <SPACE>
дүнгүүдээр	D Us NG G UUs D EE R <SPACE>
дүрбэдэхи	D Us R V EH D EH HJ I <SPACE>
дүрбэлжэн	D Us R V EH L ZH EH NG <SPACE>
дүрбэн	D Us R V EH NG <SPACE>
дүримые	D Us RJ I M Y J EH <SPACE>
дүршэл	D Us R SH EH L <SPACE>
дүршэлөөрөө	D Us R SH EH L OOs R OOs <SPACE>
дүрэ	D Us R EH <SPACE>
дүрэеэ	D Us R EH J EE <SPACE>
дүрэтэй	D Us R EH T EE <SPACE>
дүтын	D Us T Y NG <SPACE>
дүтэ	D Us T EH <SPACE>
дүтэлжэ	D Us T EH L ZH EH <SPACE>
дүтөөр	D Us T OOs R <SPACE>
дүхэригһөө	D Us H EH RJ I G HH OOs <SPACE>
дүшэн	D Us SH EH NG <SPACE>
дүшөөд	D Us SH OOs T <SPACE>
дүү	D UUs <SPACE>
дүүгээ	D UUs Gr EE <SPACE>
дүүниинь	D UUs NJ II NJ <SPACE>
дүүнэртэеэ	D UUs N EH R T EH J EE <SPACE>
дүүнэрэймни	D UUs N EH R EE M NJ I <SPACE>
дүүргэбэ	D UUs R Gr EH V EH <SPACE>
дүүргэжэ	D UUs R Gr EH ZH EH <SPACE>
дүүргэнхэй	D UUs R Gr EH N H EE <SPACE>
дүүргэхэ	D UUs R Gr EH H EH <SPACE>
дүүргэхэдэнь	D UUs R Gr EH H EH D EH NJ <SPACE>
дүүргээ	D UUs R Gr EE <SPACE>
дүүргээд	D UUs R Gr EE T <SPACE>
дүүргэһэн	D UUs R Gr EH HH EH NG <SPACE>
дүүрэн	D UUs R EH NG <SPACE>
дүүрэтэр	D UUs R EH T EH R <SPACE>
евгения	J EH V GJ EH NJ I J A <SPACE>
евэ	J E V EH <SPACE>
егорович	J E G O R O VJ I CH <SPACE>
екатерина	J E K A TJ E RJ I N A <SPACE>
елиас	J E LJ I A S <SPACE>
елизэ	J E LJ I Z EH <SPACE>
еохор	J OOh H EH R <SPACE>
ерэгты	J E R EH K T Y <SPACE>
ерэдэг	J E R EH D EH K <SPACE>
ерэдэггүй	J E R EH D EH G Gr UIs <SPACE>
ерэжэ	J E R EH ZH EH <SPACE>
ерэмсээрээ	J E R EH M S EE R EE <SPACE>
ерэн	J E R EH NG <SPACE>
ерэнхэй	J E R EH N H EE <SPACE>
ерэнэ	J E R EH N EH <SPACE>
ерэнэгүй	J E R EH N EH Gr UIs <SPACE>
ерэхэ	J E R EH H EH <SPACE>
ерэхэб	J E R EH H EH P <SPACE>
ерэхэдэнь	J E R EH H EH D EH NJ <SPACE>
ерэхэдээ	J E R EH H EH D EE <SPACE>
ерэхэл	J E R EH H EH L <SPACE>
ерээ	J E R EE <SPACE>
ерээбди	J E R EE B DJ I <SPACE>
ерээд	J E R EE T <SPACE>
ерэһэн	J E R EH HH EH NG <SPACE>
ерүүл	J E R UUs L <SPACE>
ехэ	J E H EH <SPACE>
ехэл	J E H EH L <SPACE>
ехэнхидээ	J E H EH N HJ I D EE <SPACE>
ехэтэ	J E H EH T EH <SPACE>
ехэтэй	J E H EH T EE <SPACE>
ехэхэн	J E H EH H EH NG <SPACE>
ехээр	J E H EE R <SPACE>
еши	J E SH Y <SPACE>
еһоной	J O HH EH N EE <SPACE>
еһотой	J O HH EH T EE <SPACE>
еһотойб	J O HH EH T EE P <SPACE>
жаахан	ZH AA H EH NG <SPACE>
жабай	ZH A V EE <SPACE>
жалсанов	ZH A L S A N O F <SPACE>
жамсаевнатанай	ZH A M S EH J EH V N A T EE <SPACE>
жанрда	ZH A N R D EH <SPACE>
жапович	ZH A P O VJ I CH <SPACE>
жаповичай	ZH A P O VJ I CH EE <SPACE>
жаргал	ZH A R Gr EH L <SPACE>
жаргалай	ZH A R Gr EH L EE <SPACE>
жаргалова	ZH A R Gr A L O V A <SPACE>
жаргалтай	ZH A R Gr EH L T EE <SPACE>
жаргалтайб	ZH A R Gr EH L T EE P <SPACE>
жарган	ZH A R Gr EH NG <SPACE>
жаяг	ZH A J EH K <SPACE>
жизель	ZH E Z E LJ <SPACE>
жиирэй	ZH Y R EE <SPACE>
жирафууд	ZH Y R A F UUh T <SPACE>
журамтай	ZH A R EH M T EE <SPACE>
жэгтэй	ZH E G T EE <SPACE>
жэл	ZH E L <SPACE>
жэлдэ	ZH E L D EH <SPACE>
жэлдээ	ZH E L D EE <SPACE>
жэлнүүд	ZH E L N UUs T <SPACE>
жэлэй	ZH E L EE <SPACE>
жэлэйнгээ	ZH E L EE NG G EE <SPACE>
жэлээр	ZH E L EE R <SPACE>
жэнхэни	ZH E N H EH NJ I <SPACE>
жэргэмэл	ZH E R Gr EH M EH L <SPACE>
жэшээ	ZH E SH EE <SPACE>
жэшээгээр	ZH E SH EE Gr EE R <SPACE>
жэшээлэн	ZH E SH EE L EH NG <SPACE>
жэшээнь	ZH E SH EE NJ <SPACE>
жээрэб	ZH EE R EH P <SPACE>
жюриин	ZH Uh RJ II NG <SPACE>
жүрөөдэһэн	ZH Us R OOs D EH HH EH NG <SPACE>
заабол	Z AA V EH L <SPACE>
заагдадаг	Z AA G D EH D EH K <SPACE>
заадаг	Z AA D EH K <SPACE>
заажа	Z AA ZH EH <SPACE>
заалаар	Z AA L AA R <SPACE>
заанаб	Z AA N EH P <SPACE>
зааниие	Z AA NJ II J EH <SPACE>
заатагүй	Z AA T EH Gr UIs <SPACE>
зааха	Z AA H EH <SPACE>
зааһан	Z AA HH EH NG <SPACE>
забайкалиин	Z A B A J K A LJ II NG <SPACE>
загастай	Z A Gr EH S T EE <SPACE>
зай	Z EE <SPACE>
зайгаа	Z EE Gr AA <SPACE>
зайн	Z EE NG <SPACE>
заказник	Z A K A Z NJ I K <SPACE>
зал	Z A L <SPACE>
залуу	Z A L UUh <SPACE>
залуудаа	Z A L UUh D AA <SPACE>
залуухан	Z A L UUh H EH NG <SPACE>
залуушуулай	Z A L UUh SH UUh L EE <SPACE>
залуушуулда	Z A L UUh SH UUh L D EH <SPACE>
залуушуулые	Z A L UUh SH UUh L Y J EH <SPACE>
залхуурдаг	Z A L H UUh R D EH K <SPACE>
замаар	Z A M AA R <SPACE>
замай	Z A M EE <SPACE>
зан	Z A NG <SPACE>
зандааб	Z A N D AA P <SPACE>
зандин	Z A N DJ I NG <SPACE>
зандинаархиниие	Z A N DJ I N AA R HJ I NJ II J EH <SPACE>
зандинда	Z A N DJ I N D EH <SPACE>
зандиниие	Z A N DJ I NJ II J EH <SPACE>
зандинһаа	Z A N DJ I N HH AA <SPACE>
зандинһаамни	Z A N DJ I N HH AA M NJ I <SPACE>
зантай	Z A N T EE <SPACE>
заншал	Z A N SH EH L <SPACE>
заншалаа	Z A N SH EH L AA <SPACE>
заншалта	Z A N SH EH L T EH <SPACE>
заншалтай	Z A N SH EH L T EE <SPACE>
заншалһаа	Z A N SH EH L HH AA <SPACE>
заочноор	Z A O CH N OOh R <SPACE>
зарим	Z A RJ I M <SPACE>
засаг	Z A S EH K <SPACE>
заха	Z A H EH <SPACE>
захааминай	Z A H AA MJ I N EE <SPACE>
захалаад	Z A H EH L AA T <SPACE>
захалба	Z A H EH L V EH <SPACE>
захяа	Z A HJ AA <SPACE>
заяамни	Z A J AA M NJ I <SPACE>
заяан	Z A J AA NG <SPACE>
заяанай	Z A J AA N EE <SPACE>
зибарева	Z A B A RJ E V A <SPACE>
зободог	Z O V EH D EH K <SPACE>
зобоһон	Z O V EH HH EH NG <SPACE>
зогсожо	Z O K S EH ZH EH <SPACE>
зогсон	Z O K S EH NG <SPACE>
зодоо	Z O D OOh <SPACE>
зол	Z O L <SPACE>
золгоо	Z O L Gr OOh <SPACE>
золгооб	Z O L Gr OOh P <SPACE>
золгохобиб	Z O L Gr EH H EH V I P <SPACE>
золгоһон	Z O L Gr O HH EH NG <SPACE>
золтойдоо	Z O L T EE D OOh <SPACE>
зомнайшье	Z Uh M N EE SH J EH <SPACE>
зон	Z O NG <SPACE>
зондо	Z O N D EH <SPACE>
зондоо	Z O N D OOh <SPACE>
зониие	Z O NJ II J EH <SPACE>
зоной	Z O N EE <SPACE>
зонойнгоо	Z O N EE NG G OOh <SPACE>
зоноо	Z O N OOh <SPACE>
зонтой	Z O N T EE <SPACE>
зонуудые	Z O N UUh D Y J EH <SPACE>
зонһоо	Z O N H OOh <SPACE>
зориг	Z O RJ I K <SPACE>
зорижо	Z O RJ I ZH EH <SPACE>
зорилго	Z O RJ I L Gr EH <SPACE>
зорилгодо	Z O RJ I L Gr EH D EH <SPACE>
зорилготой	Z O RJ I L Gr EH T EE <SPACE>
зориһон	Z O RJ I HH EH NG <SPACE>
зориһоные	Z O RJ I HH EH N Y J EH <SPACE>
зорюулагдаһан	Z O RJ UUh L EH G D EH HH EH NG <SPACE>
зорюулха	Z O RJ UUh L H EH <SPACE>
зорюулһан	Z O RJ UUh L HH EH NG <SPACE>
зосоо	Z O S OOh <SPACE>
зохеолнууд	Z O HJ OOh L N UUh T <SPACE>
зохидхон	Z O HJ I T H EH NG <SPACE>
зохёогшо	Z O HJ OOh K SH EH <SPACE>
зохёол	Z O HJ OOh L <SPACE>
зохёолнууд	Z O HJ OOh L N UUh T <SPACE>
зохёолнуудаа	Z O HJ OOh L N UUh D AA <SPACE>
зохёолнуудые	Z O HJ OOh L N UUh D Y J EH <SPACE>
зохёолой	Z O HJ OOh L EE <SPACE>
зохёолшод	Z O HJ OOh L SH EH T <SPACE>
зохёолшодой	Z O HJ OOh L SH EH D EE <SPACE>
зохёолые	Z O HJ OOh L Y J EH <SPACE>
зохёохо	Z O HJ OOh H EH <SPACE>
зохёохы	Z O HJ OOh H Y <SPACE>
зохёоһон	Z O HJ OOh HH EH NG <SPACE>
зубхиёо	Z Uh P HJ I J OOh <SPACE>
зугаа	Z Uh Gr AA <SPACE>
зугаатай	Z Uh Gr AA T EE <SPACE>
зугааша	Z Uh Gr AA SH EH <SPACE>
зугадаа	Z Uh Gr EH D AA <SPACE>
зузаан	Z Uh Z AA NG <SPACE>
зунай	Z Uh N EE <SPACE>
зундаа	Z Uh N D AA <SPACE>
зурааша	Z Uh R AA SH AA <SPACE>
зураашанайруулагшаар	Z Uh R AA SH EH N EE R UUh L EH K SH AA R <SPACE>
зураашадаар	Z Uh R AA SH EH D AA R <SPACE>
зураг	Z Uh R EH K <SPACE>
зурагай	Z Uh R EH Gr EE <SPACE>
зураглагдана	Z Uh R EH G L EH G D EH N EH <SPACE>
зураглажа	Z Uh R EH G L EH ZH EH <SPACE>
зурагта	Z Uh R EH K T EH <SPACE>
зурагууд	Z Uh R EH Gr UUh T <SPACE>
зурагуудай	Z Uh R EH Gr UUh D EE <SPACE>
зурагуудтай	Z Uh R EH Gr UUh T T EE <SPACE>
зурана	Z Uh R EH N EH <SPACE>
зураха	Z Uh R EH H EH <SPACE>
зургаадахи	Z Uh R Gr AA D EH HJ I <SPACE>
зургаанда	Z Uh R Gr AA N D EH <SPACE>
зуун	Z UUh NG <SPACE>
зуураа	Z UUh R AA <SPACE>
зууршалагдаһан	Z UUh R SH EH L EH Gr D EH HH EH NG <SPACE>
зэбсэгүүдые	Z E P S EH Gr UUs D Y J EH <SPACE>
зэдын	Z E D Y NG <SPACE>
зэдэлшэхэдэл	Z E D EH L SH EH H EH D EH L <SPACE>
зэдэлһэн	Z E D EH L HH EH NG <SPACE>
зэмэлнэб	Z E M EH L N EH P <SPACE>
зэргэ	Z E R Gr EH <SPACE>
зэргэдэ	Z E R Gr EH D EH <SPACE>
зэрлиг	Z E R LJ I K <SPACE>
зээ	Z EE <SPACE>
зүб	Z Us P <SPACE>
зүбшөөл	Z Us P SH OOs L <SPACE>
зүг	Z Us K <SPACE>
зүгын	Z Us Gr Y NG <SPACE>
зүгэй	Z Us Gr EE <SPACE>
зүгһөө	Z Us G HH OOs <SPACE>
зүгөөр	Z Us Gr OOs R <SPACE>
зүдхэли	Z Us D H EH LJ I <SPACE>
зүдхэлиин	Z Us D EH LJ II NG <SPACE>
зүжэг	Z Us ZH EH K <SPACE>
зүжэгтэ	Z Us ZH EH K T EH <SPACE>
зүжэгшэн	Z Us ZH EH K SH EH NG <SPACE>
зүжэгынь	Z Us ZH EH Gr Y NJ <SPACE>
зүжэгүүдтэ	Z Us ZH EH Gr UUs T T EH <SPACE>
зүйлнүүд	Z UIs L N UUs T <SPACE>
зүлхэ	Z Us L H EH <SPACE>
зүлхэйн	Z Us L H EE NG <SPACE>
зүрхые	Z Us R H Y J EH <SPACE>
зүрхэ	Z Us R H EH <SPACE>
зүрхэмни	Z Us R H EH M NJ I <SPACE>
зүрхэнэйм	Z Us R H EH N EE M <SPACE>
зүрхэнэйнгөө	Z Us R H EH N EE NG G OOs <SPACE>
зүрхэнһөө	Z Us R H EH N HH OOs <SPACE>
зүүн	Z UUs NG <SPACE>
зөөлэн	Z OOs L EH NG <SPACE>
зөөри	Z OOs RJ I <SPACE>
зөөриин	Z OOs RJ II NG <SPACE>
зөөритэй	Z OOs RJ I T EE <SPACE>
зөөхэй	Z OOs H EE <SPACE>
и	I <SPACE>
ивалгын	I V EH L Gr Y NG <SPACE>
иванов	I V A N O F <SPACE>
ивановна	I V A N O V N A <SPACE>
ивановой	I V A N O V EE <SPACE>
ивановтой	I V A N O F T EE <SPACE>
ивато	I V A T O <SPACE>
из	I Z <SPACE>
иигэжэ	II Gr EH ZH EH <SPACE>
иигэжэл	II Gr EH ZH EH L <SPACE>
иигээд	II Gr EE T <SPACE>
иимэ	II M EH <SPACE>
иимэрхүү	II M EH R H UUs <SPACE>
иишэ	II SH EH <SPACE>
иишээ	II SH EE <SPACE>
илагшадай	I L EH K SH EH D EE <SPACE>
илажа	I L EH ZH EH <SPACE>
илангаяа	I L EH NG G A J AA <SPACE>
импери	I M PJ E RJ I <SPACE>
империин	I M PJ E RJ II NG <SPACE>
инаг	I N EH K <SPACE>
инагуудай	I N EH Gr UUh D EE <SPACE>
индостанай	I N D EH S T A N EE <SPACE>
индус	I N D Uh S <SPACE>
индустриальна	I N D Uh S T RJ I A LJ N EH <SPACE>
инженербиотехнологой	I N ZH EH NJ E R BJ I O TJ E H N O L EH G EE <SPACE>
иннокентьевич	I N N O KJ E N TJ J E VJ I CH <SPACE>
иннокентьевна	I N N O KJ E N TJ J E V N A <SPACE>
институдай	I N S TJ I T Uh D EE <SPACE>
институдта	I N S TJ I T Uh T T EH <SPACE>
институт	I NJ S T TJ I T Uh T <SPACE>
интернадта	I N T E R N A T T EH <SPACE>
интернедтэ	I N T E R N EH T T EH <SPACE>
интернет	I N T E R N EH T <SPACE>
информ	I N F O R M <SPACE>
ирина	I RJ I N EH <SPACE>
исимбаев	I SJ I M B A J E F <SPACE>
искусство	I S K Uh S S T V EH <SPACE>
искусствын	I S K Uh S S T V Y NG <SPACE>
июниин	I J Uh NJ II NG <SPACE>
июниинь	I J Uh NJ II NJ <SPACE>
кабул	K A V Uh L <SPACE>
камбоджа	K A M B O D ZH EH <SPACE>
канадын	K A N A D Y NG <SPACE>
каникулы	K A NJ I K Uh L Y <SPACE>
катя	K A TJ A <SPACE>
кексэ	KJ E K S EH <SPACE>
килограмм	KJ I L O G R A M <SPACE>
кино	KJ I N O <SPACE>
киногоо	KJ I N O Gr OOh <SPACE>
кинодо	KJ I N O D EH <SPACE>
киномеханигаар	KJ I N O MJ E H A NJ I Gr AA R <SPACE>
кинорежиссёр	KJ I N O RJ E ZH Y S SJ OOh R <SPACE>
киностудинь	KJ I N O S T Uh DJ I NJ <SPACE>
кинофестиваль	KJ I N O FJ E S TJ I V A LJ <SPACE>
кинофильм	KJ I N O FJ I LJ M <SPACE>
кинофильмнүүд	KJ I N O FJ I LJ M N UUs T <SPACE>
кинофильмнүүдтэ	KJ I N O FJ I LJ M N UUs T T EH <SPACE>
кинофильмын	KJ I N O FJ I LJ M Y NG <SPACE>
кихот	KJ I H O T <SPACE>
класс	K L A S S <SPACE>
классай	K L A S S EE <SPACE>
классайнь	K L A S S EE NJ <SPACE>
классигуудай	K L A S SJ I Gr UUh D EE <SPACE>
классигуудые	K L A S SJ I Gr UUh D Y J EH <SPACE>
класста	K L A S S T EH <SPACE>
классуудта	K L A S S UUh T T EH <SPACE>
клуб	K L Uh P <SPACE>
клубые	K L Uh B Y J EH <SPACE>
км	K M <SPACE>
код	K O T <SPACE>
коллективтэй	K O L LJ E K TJ I F T EE <SPACE>
колхоз	K O L H O S <SPACE>
колхоздоо	K O L H O Z D OOh <SPACE>
колхозой	K O L H O Z EE <SPACE>
команда	K O M A N D EH <SPACE>
командын	K O M A N D Y NG <SPACE>
комиссиин	K O MJ I S SJ I NG <SPACE>
компьютер	K O M PJ J Uh TJ E R <SPACE>
компьютерна	K O M PJ J Uh TJ E R N EH <SPACE>
комсоргоор	K O M S EH R Gr OOh R <SPACE>
кондратьев	K O N D R A TJ J E F <SPACE>
кондратьевай	K O N D R A TJ J E V EE <SPACE>
концерт	K O N C E R T <SPACE>
концертын	K O N C E R T Y NG <SPACE>
корреспондент	K O R RJ E S P O N DJ E N T <SPACE>
космонавт	K O S M O N A F T <SPACE>
кофе	K O FJ EH <SPACE>
кофеһоо	K O FJ EH HH OOh <SPACE>
ксения	K SJ E NJ I J A <SPACE>
ксилитоол	K SJ I LJ I T O L <SPACE>
культпросвет	K Uh LJ T P R O S VJ E T <SPACE>
куполдо	K Uh P EH L D EH <SPACE>
курсда	K Uh R S D EH <SPACE>
курсые	K Uh R S Y J EH <SPACE>
лавренюк	L A V RJ E NJ Uh K <SPACE>
лагерь	L A GJ E RJ <SPACE>
лалын	L A L Y NG <SPACE>
лама	L A M EH <SPACE>
лангхау	L A N H A Uh <SPACE>
ланка	L A N K EH <SPACE>
лаос	L A O S <SPACE>
лариса	L A RJ I S A <SPACE>
лауреат	L A Uh RJ E A T <SPACE>
лебединое	LJ E BJ E DJ I N O J E <SPACE>
лекци	LJ E K C Y <SPACE>
ленинград	LJ E NJ I NG G R A T <SPACE>
ленточнэ	LJ E N T EH CH N EH <SPACE>
ленэ	LJ E N EH <SPACE>
литература	LJ I TJ E R A T Uh R EH <SPACE>
литератураар	LJ I TJ E R A T Uh R AA R <SPACE>
литературын	LJ I TJ E R A T Uh R Y NG <SPACE>
литр	LJ I T R <SPACE>
литрэй	LJ I T R EE <SPACE>
лицейинтернадай	LJ I C EE I N T E R N A D EE <SPACE>
лицейинтернадта	LJ I C EE I N T E R N A D T EH <SPACE>
лицейинтернадһаа	LJ I C EE I N T E R N A D HH AA <SPACE>
лопсон	L O P S EH NG <SPACE>
лочиновна	L O CH I N O V N A <SPACE>
лучший	L Uh CH SH Y J <SPACE>
лыгденов	L Y G DJ E N O F <SPACE>
лыгденовтэ	L Y G DJ E N O V T EE <SPACE>
лыгденовтэнэй	L Y G DJ E N O F T EH N EE <SPACE>
лыгденовэй	L Y G DJ E N O V EE <SPACE>
лэ	L EH <SPACE>
любви	LJ Uh B VJ I <SPACE>
маанадта	M AA N EH T T EH <SPACE>
маанараар	M AA N EH R AA R <SPACE>
маанарта	M AA N EH R T EH <SPACE>
маанарые	M AA N EH R Y J EH <SPACE>
маатти	M AA T TJ I <SPACE>
мааттида	M AA T TJ I D EH <SPACE>
магад	M A Gr EH D <SPACE>
магазин	M A Gr A ZJ I NG <SPACE>
магдан	M A G D EH NG <SPACE>
магданай	M A G D EH N EE <SPACE>
магна	M A NG EH <SPACE>
магтаа	M A K T AA <SPACE>
магтан	M A K T EH NG <SPACE>
магтанам	M A K T EH M EH M <SPACE>
майин	M EE J NG <SPACE>
майя	M A J A <SPACE>
мал	M A L <SPACE>
малаа	M A L AA <SPACE>
малай	M A L EE <SPACE>
малтай	M A L T EE <SPACE>
малша	M A L SH EH <SPACE>
малыеголы	M A L Y J EH G O L Y <SPACE>
манаа	M A N AA <SPACE>
манай	M A N EE <SPACE>
манайшье	M A N EE SH J EH <SPACE>
мандухаев	M A N D Uh H A J EH F <SPACE>
мария	M A RJ J A <SPACE>
мартаа	M A R T AA <SPACE>
мартаагүй	M A R T AA Gr UIs <SPACE>
мартаад	M A R T AA T <SPACE>
мартагдашагүй	M A R T EH G D EH SH EH Gr UIs <SPACE>
мартадаггүй	M A R T EH D EH G Gr UIs <SPACE>
мархаева	M A R H A J EH V A <SPACE>
мастер	M A S TJ E R <SPACE>
мастернуудые	M A S TJ E R N UUh D Y J EH <SPACE>
математика	M A TJ E M A TJ I K A <SPACE>
матикайнэн	M A TJ I K EE N E NG <SPACE>
матти	M A T TJ I <SPACE>
маттиин	M A T TJ I NG <SPACE>
маттинай	M A T TJ I N EE <SPACE>
махмуд	M A H M Uh T <SPACE>
машина	M A SH Y N EH <SPACE>
машинаар	M A SH Y N AA R <SPACE>
машинын	M A SH Y N Y NG <SPACE>
маяг	M A J A K <SPACE>
метр	MJ E T R <SPACE>
механизатораар	MJ E H A NJ I Z A T O R AA R <SPACE>
миин	MJ II NG <SPACE>
минжур	MJ N ZH UUh R <SPACE>
мини	MJ I NJ I <SPACE>
минии	MJ I NJ II <SPACE>
министерствын	MJ I NJ I S TJ E R S T V Y NG <SPACE>
минутын	MJ I N UUh T Y NG <SPACE>
миссия	MJ I S SJ I A <SPACE>
митрошкинатай	M I T R O SH KJ I N EH T EE <SPACE>
митупов	MJ I T Uh P O F <SPACE>
михеевич	MJ I HJ E J E VJ I CH <SPACE>
михей	MJ E HJ E J <SPACE>
михуулай	MJ I H UUh L EE <SPACE>
мишра	MJ I SH H EH <SPACE>
мм	M M <SPACE>
могол	M O Gr EH L <SPACE>
моголнуудай	M O Gr EH L N UUh D EE <SPACE>
могоолнуудай	M O Gr OOh L N UUh D EE <SPACE>
модо	M O D EH <SPACE>
модон	M O D EH NG <SPACE>
модоной	M O D EH N EE <SPACE>
мойһоор	M OE HH OOh R <SPACE>
мон	M O NG <SPACE>
монгол	M O NG Gr EH L <SPACE>
монголбуряадуудай	M O NG G EH L B Uh RJ AA D UUh D EE <SPACE>
монголой	M O NG G EH L EE <SPACE>
монголоо	M O NG G EH L OOh <SPACE>
монголшуудай	M O NG G EH L SH UUh D EE <SPACE>
монголһоо	M O NG G EH L HH OOh <SPACE>
мордоо	M O R D OOh <SPACE>
мордохом	M O R D EH H EH M <SPACE>
морин	M O RJ I NG <SPACE>
мориндо	M O RJ I N D EH <SPACE>
мориной	M O RJ I N EE <SPACE>
моринуудараа	M Uh RJ I N UUh D EH R AA <SPACE>
морихиро	M O RJ I HJ I R EH <SPACE>
морожено	M O R O ZH EH N EH <SPACE>
москва	M O S K V A <SPACE>
москвагай	M O S K V A Gr EE <SPACE>
москвадашье	M O S K V A D EH SH J EH <SPACE>
музей	M Uh ZJ EE <SPACE>
мундаргата	M Uh N D EH R Gr EH D EH <SPACE>
мундаргын	M Uh N D EH R Gr Y NG <SPACE>
мургаб	M Uh R Gr EH P <SPACE>
мусульман	M Uh S Uh LJ M A NG <SPACE>
муу	M UUh <SPACE>
муутай	M UUh T EE <SPACE>
муухайда	M UUh H EE D EH <SPACE>
мухаршэбэрэй	M Uh H EH R SH EH V EH R EE <SPACE>
мы	M Y <SPACE>
мэгдэншьегүй	M E G D EH N SH J EH Gr UIs <SPACE>
мэдэгдэжэ	M E D EH G D EH ZH EH <SPACE>
мэдэгма	M E D EH G M AA <SPACE>
мэдэдэг	M E D EH D EH K <SPACE>
мэдэдэггүй	M E D EH D EH G Gr UIs <SPACE>
мэдэжэ	M E D EH ZH EH <SPACE>
мэдэлдэ	M E D EH L D EH <SPACE>
мэдэн	M E D EH NG <SPACE>
мэдэнгүй	M E D EH NG G UIs <SPACE>
мэдэнэгүй	M E D EH N EH Gr UIs <SPACE>
мэдэрдэг	M E D EH R D EH K <SPACE>
мэдэржэ M E D EH R ZH EH <SPACE>
мэдэрнэ	M E D EH R N EH <SPACE>
мэдэрнэбди	M E D EH R N EH B DJ I <SPACE>
мэдэрэл	M E D EH R EH L <SPACE>
мэдэрэлээр	M E D EH R EH L EE R <SPACE>
мэдэсэеэ	M E D EH S EH J EE <SPACE>
мэдэхэ	M E D EH H EH <SPACE>
мэдэхэбибди	M E D EH H EH VJ I B DJ I <SPACE>
мэдэхэгүй	M E D EH H EH Gr UIs <SPACE>
мэдээд	M E D EE T <SPACE>
мэдээжэ	M E D EE ZH EH <SPACE>
мэдээсэл	M E D EE S EH L <SPACE>
мэдээсэлдэ	M E D EE S EH L D EH <SPACE>
мэдээсэлэй	M E D EE S EH L EE <SPACE>
мэдүүлбэ	M E D UUs L V EH <SPACE>
мэдүүлэл	M E D UUs L EH L <SPACE>
мэлс	M E L S <SPACE>
мэргэдэй	M E R Gr EH D EE <SPACE>
мэргэжэл	M E R Gr EH ZH EH L <SPACE>
мэргэжэлтэ	M E R Gr EH ZH EH L T EH <SPACE>
мэргэжэлтэд	M E R Gr EH ZH EH T T EH T <SPACE>
мэргэжэлтэй	M E R Gr EH ZH EH L T EE <SPACE>
мэргэжэлые	M E R Gr EH ZH EH L Y J EH <SPACE>
мэргэжэлэй	M E R Gr EH ZH EH L EE <SPACE>
мэргэжэлээрээ	M E R Gr EH ZH EH L EE R EE <SPACE>
мэргэн	M E R Gr EH NG <SPACE>
мэтэ	M E T EH <SPACE>
мэтэр	M E T EH R <SPACE>
мэтээр	M E T EE R <SPACE>
мэхэлэгдээд	M E H EH L EH G D EE T <SPACE>
мэхэлээгүй	M E H EH L EE Gr UIs <SPACE>
мэү	M E <SPACE>
мянга	MJ A NG G EH <SPACE>
мянгаад	MJ A NG G AA T <SPACE>
мянган	MJ A NG G EH NG <SPACE>
мяха	MJ A H EH <SPACE>
мүлижэ	M Us LJ I ZH EH <SPACE>
мүлиһэн	M Us LJ I HH EH NG <SPACE>
мүн	M Us NG <SPACE>
мүнгэ	M Us NG G EH <SPACE>
мүнгэн	M Us NG G EH NG <SPACE>
мүндэлһэн	M Us N D EH L HH EH NG <SPACE>
мүндэлөөд	M Us N D EH L OOs T <SPACE>
мүнхэ	M Us N H EH <SPACE>
мүнхэрөө	M Us N H EH R OOs <SPACE>
мүнэһэн	M Us N EH HH EH NG <SPACE>
мүнөө	M Us N OOs <SPACE>
мүнөөдэр	M Us N OOs D EH R <SPACE>
мүнөөдэрэй	M Us N OOs D EH R EE <SPACE>
мүнөөшье	M Us N OOs SH J EH <SPACE>
мүр	M Us R <SPACE>
мүргэдэг	M Us R Gr EH D EH K <SPACE>
мүргэл	M Us R Gr EH L <SPACE>
мүргэхэ	M Us R Gr EH H EH <SPACE>
мүрнүүд	M Us R N UUs T <SPACE>
мүрнүүдээрээ	M Us R N UUs D EE R EE <SPACE>
мүрнүүдһээ	M Us R N UUs D HH EE <SPACE>
мүртэй	M Us R T EE <SPACE>
мүрысэжэ	M Us R Y S EH ZH EH <SPACE>
мүрысөөн	M Us R Y S OOs NG <SPACE>
мүрэн	M Us R EH NG <SPACE>
мүрэнэй	M Us R EH N EE <SPACE>
мүрэнүүд	M Us R EH N UUs T <SPACE>
мүрөө	M Us R OOs <SPACE>
мүшэдэй	M Us SH EH D EE <SPACE>
мүүнөөдэр	M UUs N OOs D EH R <SPACE>
мүүрнүүд	M UUs R N UUs T <SPACE>
мүүрнүүдэй	M UUs R N UUs D EE <SPACE>
наада	N AA D EH <SPACE>
наадаар	N AA D AA R <SPACE>
наадан	N AA D EH NG <SPACE>
нааданай	N AA D EH N EE <SPACE>
нааданда	N AA D EH N D EH <SPACE>
наадаяа	N AA D EH J AA <SPACE>
наашаа	N AA SH AA <SPACE>
нагаса	N A Gr EH S EH <SPACE>
надежда	N A DJ E ZH D EH <SPACE>
нажарынь	N A ZH EH R Y NJ <SPACE>
найгалзаад	N EE Gr EH L Z AA T <SPACE>
найдал	N EE D EH L <SPACE>
найдамтай	N EE D EH M T EE <SPACE>
найман	N EE M EH NG <SPACE>
найрай	N EE R EE <SPACE>
найрлаа	N EE R L AA <SPACE>
найруулагша	N EE R UUh L EH G SH EH <SPACE>
найруулагшаар	N EE R UUh L EH G SH AA R <SPACE>
найруулагшын	N EE R UUh L EH G SH Y NG <SPACE>
найруулан	N EE R UUh L EH NG <SPACE>
намааршье	N A M AA R SH J EH <SPACE>
намайе	N A M EE J EH <SPACE>
намарай	N A M EH R EE <SPACE>
намда	N A M D EH <SPACE>
намжаа	N A M ZH AA <SPACE>
намжилма	N A M ZH Y L M A <SPACE>
намтарта	N A M T EH R T EH <SPACE>
намтаяа	N A M T A J AA <SPACE>
нангин	N A NG GJ I NG <SPACE>
нангинаар	N A NG GJ I N AA R <SPACE>
нанхяад	N A NG HJ AA T <SPACE>
нарай	N A R EE <SPACE>
наран	N A R EH NG <SPACE>
наранай	N A R EH N EE <SPACE>
нарин	N A RJ I NG <SPACE>
наринаар	N A RJ I N AA R <SPACE>
национальна	N A C Y O N A LJ N EH <SPACE>
наһа	N A HH EH <SPACE>
наһаараа	N A HH AA R AA <SPACE>
наһажаал	N A HH EH ZH AA L <SPACE>
наһан	N A HH EH NG <SPACE>
наһанай	N A HH EH N EE <SPACE>
наһанайм	N A HH EH N EE M <SPACE>
наһанайнгаа	N A HH EH N EE NG G AA <SPACE>
наһандаа	N A HH EH N D AA <SPACE>
наһандань	N A HH EH N D EH NJ <SPACE>
наһанһаа	N A HH EH N HH AA <SPACE>
наһанһаань	N A HH EH N HH AA NJ <SPACE>
наһатай	N A HH EH T EE <SPACE>
невыполнима	NJ E V Y P O L NJ I M EH <SPACE>
неделидэ	NJ E DJ E LJ I D EH <SPACE>
нива	NJ I V A <SPACE>
ниислэл	NJ II S L EH L <SPACE>
ниитын	NJ II T Y NG <SPACE>
ниитэ	NJ II T EH <SPACE>
николаевич	NJ I K O L A J E VJ I CH <SPACE>
нилээд	NJ I L EE T <SPACE>
нилээн	NJ I L EE NG <SPACE>
ногоон	N O Gr OOh NG <SPACE>
нойтон	N OE T EH NG <SPACE>
нойтотой	N OE T EH T EE <SPACE>
ном	N O M <SPACE>
номгон	N O M Gr EH NG <SPACE>
номдо	N O M D EH <SPACE>
номинацида	N O MJ I N A C Y D EH <SPACE>
номой	N O M EE <SPACE>
номууд	N O M UUh T <SPACE>
номуудай	N O M UUh D EE <SPACE>
номуудта	N O M UUh T T EH <SPACE>
номыень	N O M Y J EH NJ <SPACE>
нооһо	N OOh HH EH <SPACE>
норбоева	N O R B O J EH V A <SPACE>
нохой	N O H EE <SPACE>
ночь	N O CH <SPACE>
ноябрь	N O J A B RJ <SPACE>
ноёдто	N O J O D T EH <SPACE>
ноёхоной	N O J O H EH N EE <SPACE>
нугануудаар	N Uh Gr A N UUh D AA R <SPACE>
нуганууднай	N Uh Gr EH N UUh D EE <SPACE>
нугархай	N Uh Gr EH R H EE <SPACE>
нугархайгаар	N Uh Gr EH R H EE Gr AA R <SPACE>
нугархайень	N Uh Gr EH R H EH J EH NJ <SPACE>
нуур	N UUh R <SPACE>
нэбтэрүүлэгдэжэ	N E P T EH R UUs L EH G D EH ZH EH <SPACE>
нэбтэрүүлэгдэн	N E P T EH R UUs L EH G D EH NG <SPACE>
нэгые	N E Gr Y J EH <SPACE>
нэгэ	N E Gr EH <SPACE>
нэгэдэн	N E Gr EH D EH NG <SPACE>
нэгэдэхи	N E Gr EH D EH HJ I <SPACE>
нэгэдүүлхэ	N E Gr EH D UUs L H EH <SPACE>
нэгэдүүлэгдэһэн	N E Gr EH D UUs L EH G D EH HH EH NG <SPACE>
нэгэл	N E Gr EH L <SPACE>
нэгэмнай	N E Gr EH M N EE <SPACE>
нэгэн	N E Gr EH NG <SPACE>
нэгэндэ	N E Gr EH N D EH <SPACE>
нэгэниинь	N E Gr EH NJ II NJ <SPACE>
нэгэтэ	N E Gr EH T EH <SPACE>
нэгэшье	N E Gr EH SH J EH <SPACE>
нэмэжэ	N E M EH ZH EH <SPACE>
нэн	N E NG <SPACE>
нэрлээд	N E R L EE T <SPACE>
нэрлүүлжэ	N E R L UUs L ZH EH <SPACE>
нэрые	N E R Y J EH <SPACE>
нэрэ	N E R EH <SPACE>
нэрэеэ	N E R EH J EE <SPACE>
нэрэмжэтэ	N E R EH M ZH EH T EH <SPACE>
нэрэнэ	N E R EH N EH <SPACE>
нэрэтэй	N E R EH T EE <SPACE>
нэрэхэ	N E R EH H EH <SPACE>
нэрээ	N E R EE <SPACE>
нэха	N E H EH <SPACE>
нээгдээ	N EE G D EE <SPACE>
нээжэ	N EE ZH EH <SPACE>
нээрээшье	N EE R EE SH J EH <SPACE>
нээхэ	N EE H EH <SPACE>
нээхэдэ	N EE H EH D EH <SPACE>
нээхэдэнь	N EE H EH D EH NJ <SPACE>
нээһэн	N EE HH EH NG <SPACE>
нюдэндэ	NJ Uh D EH N D EH <SPACE>
нюдэниинь	NJ Uh D EH NJ II NJ <SPACE>
нюдэнсоошни	NJ Uh D EH N S OOh SH NJ I <SPACE>
нюрган	NJ Uh R Gr EH NG <SPACE>
нютаг	NJ Uh T EH K <SPACE>
нютагаа	NJ Uh T EH Gr AA <SPACE>
нютагаархидынь	NJ Uh T EH Gr AA R HJ I D Y NJ <SPACE>
нютагай	NJ Uh T EH Gr EE <SPACE>
нютагайнгаа	NJ Uh T EH Gr EE NG G AA <SPACE>
нютагайнь	NJ Uh T EH Gr EE NJ <SPACE>
нютагайхид	NJ Uh T EH Gr EE HJ I T <SPACE>
нютагайхидайнгаа	NJ Uh T EH Gr EE HJ I D EE NG G AA <SPACE>
нютагни	NJ Uh T EH G NJ I <SPACE>
нютагта	NJ Uh T EH K T EH <SPACE>
нютагтаа	NJ Uh T EH K T AA <SPACE>
нютагтай	NJ Uh T EH K T EE <SPACE>
нютагтамнай	NJ Uh T EH K T EH M N EE <SPACE>
нютагтань	NJ Uh T EH K T EH NJ <SPACE>
нютагууд	NJ Uh T EH Gr UUh T <SPACE>
нютагуудаар	NJ Uh T EH Gr UUh D AA R <SPACE>
нютагые	NJ Uh T EH Gr Y J EH <SPACE>
нютагһаа	NJ Uh T EH G HH AA <SPACE>
нюурта	NJ UUh R T EH <SPACE>
нюусануудаар	NJ Uh S EH N UUh D AA R <SPACE>
нягта	NJ A K T EH <SPACE>
нёдондо	NJ O D EH N D EH <SPACE>
нүгөө	N Us Gr OOs <SPACE>
нүлөө	N Us L OOs <SPACE>
нүлөөлэлгдэнэ	N Us L OOs L E L G D EH N EH <SPACE>
нүлөөлһэн	N Us L OOs L HH EH NG <SPACE>
нүхэд	N Us H EH T <SPACE>
нүхэдни	N Us H EH D NJ I <SPACE>
нүхэдынь	N Us H EH D Y NJ <SPACE>
нүхэр	N Us H EH R <SPACE>
нүхэртэ	N Us H EH R T EH <SPACE>
нүхэртэеэ	N Us H EH R T EH J EE <SPACE>
нүхэртэй	N Us H EH R T EE <SPACE>
нүхэрэй	N Us H EH R EE <SPACE>
нүхэрэйнгөө	N Us H EH R EE NG G OOs <SPACE>
нүхэсэлэй	N Us H EH S EH L EE <SPACE>
нүүдэлшэ	N UUs D EH L SH EH <SPACE>
нүүдэлшэдэй	N UUs D EH L SH EH D EE <SPACE>
обитаемый	O BJ I T A J E M Y J <SPACE>
обогууд	O V EH Gr UUh T <SPACE>
обоодоо	O V OOh D OOh <SPACE>
обёоржо	O VJ OOh R ZH EH <SPACE>
огто	O K T EH <SPACE>
одна	O D N EH <SPACE>
одо	O D EH <SPACE>
одоевич	O D O J E VJ I CH <SPACE>
одоо	O D OOh <SPACE>
одоол	O D OOh L <SPACE>
одхон	O T H EH NG <SPACE>
озеро	O ZJ EH R O <SPACE>
ой	OE <SPACE>
ойлгодогби	OE L Gr EH D EH G BJ I <SPACE>
ойлгое	OE L Gr EH J EH <SPACE>
ойлгожо	OE L Gr EH ZH EH <SPACE>
ойлгон	OE L Gr EH NG <SPACE>
ойлгоогүй	OE L Gr OOh Gr UIs <SPACE>
ойлгоходоо	OE L Gr EH H EH D OOh <SPACE>
ойлгуулжа	OE L Gr UUh L ZH EH <SPACE>
ойн	OE NG <SPACE>
ойрод	OE R EH T <SPACE>
окладников	O K L A D NJ I K O F <SPACE>
олдоно	O L D EH N EH <SPACE>
олдоногүй	O L D EH N EH Gr UIs <SPACE>
олдоогүй	O L D OOh Gr UIs <SPACE>
олдохо	O L D EH H EH <SPACE>
олзо	O L Z EH <SPACE>
олзын	O L Z Y NG <SPACE>
олимпиада	O LJ I M PJ I A D A <SPACE>
олимпиадада	O LJ I M PJ I A D EH D EH <SPACE>
олимпиаданууд	O LJ I M PJ I A D A D EH N UUh T <SPACE>
оло	O L EH <SPACE>
олой	O L EE <SPACE>
ололсожо	O L EH L S EH ZH EH <SPACE>
олон	O L EH NG <SPACE>
олонгоо	O L EH NG G OOh <SPACE>
олонгүй	O L EH NG G UIs <SPACE>
олондо	O L EH N D EH <SPACE>
олониие	O L EH NJ II J EH <SPACE>
олониитын	O L EH NJ II T Y NG <SPACE>
олонхи	O L EH N H I <SPACE>
олонхимнай	O L EH N HJ I M N EE <SPACE>
олоод	O L OOh T <SPACE>
олоор	O L OOh R <SPACE>
олоороо	O L OOh R OOh <SPACE>
олошорхо	O L EH SH EH R H EH <SPACE>
олоһоор	O L EH HH OOh R <SPACE>
ольга	O LJ G EH <SPACE>
ольтирогуудаар	O LJ TJ I R O Gr UUh D AA R <SPACE>
омар	O M EH R <SPACE>
омогорхол	O M EH Gr EH R H EH L <SPACE>
он	O NG <SPACE>
ондо	O N D EH <SPACE>
ондоо	O N D OOh <SPACE>
оной	O N EE <SPACE>
онол	O N EH L <SPACE>
ономастика	O N EH M A S TJ I K A <SPACE>
онсо	O N S EH <SPACE>
онтохон	O N T EH H EH NG <SPACE>
онууд	O N UUh T <SPACE>
онуудта	O N UUh T T EH <SPACE>
онһоо	O N HH OOh <SPACE>
оперо	O PJ EH R EH <SPACE>
ордон	O R D EH NG <SPACE>
ордонтой	O R D EH N T EE <SPACE>
ореолто	O RJ O L T EH <SPACE>
ореолтонуудай	O RJ OOh L T EH N UUh D EE <SPACE>
ори	O RJ I <SPACE>
орилхыень	O RJ I L H Y J EH NJ <SPACE>
оробо	O R O V EH <SPACE>
ород	O R EH T <SPACE>
орожо	O R O ZH EH <SPACE>
орой	O R EE <SPACE>
оройгдооб	O R EE G D OOh P <SPACE>
оройдоо	O R EE D OOh <SPACE>
оройдоол	O R EE D OOh L <SPACE>
оройе	O R EE J EH <SPACE>
оройнууд	O R EE N UUh T <SPACE>
оролдодог	O R EH L D EH D EH K <SPACE>
оролдодогби	O R EH L D EH D EH G BJ I <SPACE>
оролдожол	O R EH L D EH ZH EH L <SPACE>
оролдолго	O R EH L D EH L Gr EH <SPACE>
оролдолгоор	O R EH L D EH L Gr OOh R <SPACE>
оролдоо	O R EH L D OOh <SPACE>
оролсоно	O R EH L S EH N EH <SPACE>
орон	O R EH NG <SPACE>
орондо	O R EH N D EH <SPACE>
орондоо	O R EH N D OOh <SPACE>
ороной	O R EH N EE <SPACE>
ороноймнай	O R EH N EE M N EE <SPACE>
оронойнгоо	O R EH N OE NG G OOh <SPACE>
ороноор	O R EH N OOh R <SPACE>
оронхой	O R EH N H EE <SPACE>
ороо	O R OOh <SPACE>
орооб	O R OOh P <SPACE>
ороод	O R OOh T <SPACE>
орохо	O R O H EH <SPACE>
орохоб	O R O H EH P <SPACE>
орохобди	O R O H EH B DJ I <SPACE>
ороходоо	O R O H EH D OOh <SPACE>
орохыень	O R O H Y J EH NJ <SPACE>
ороһон	O R EH HH EH NG <SPACE>
ороһоор	O R EH HH OOh R <SPACE>
оруулагдана	O R UUh L EH G D EH N EH <SPACE>
оруулбал	O R UUh L V EH L <SPACE>
оруулдаг	O R UUh L D EH K <SPACE>
оруулжа	O R UUh L ZH EH <SPACE>
орхеоб	O R HJ OOh P <SPACE>
орхигдоһон	O R HJ I G D EH HH EH NG <SPACE>
оршодог	O R SH EH D EH K <SPACE>
оршом	O R SH EH M <SPACE>
оршоһон	O R SH EH HH EH NG <SPACE>
оршуулагша	O R SH UUh L EH G SH EH <SPACE>
орёо	O RJ OOh <SPACE>
орёохон	O RJ OOh H EH NG <SPACE>
остров	O S T R O F <SPACE>
отделенидэ	O T DJ EH LJ EH NJ I D EH <SPACE>
оулуһаань	O Uh L Uh HH AA NJ <SPACE>
охин	O HJ I NG <SPACE>
охрын	O R H Y NG <SPACE>
очно	O CH N EH <SPACE>
ошобобди	O SH EH V EH B DJ I <SPACE>
ошодог	O SH EH D EH K <SPACE>
ошодоггүй	O SH EH D EH G Gr UIs <SPACE>
ошожо	O SH EH ZH EH <SPACE>
ошолго	O SH EH L Gr EH <SPACE>
ошон	O SH EH NG <SPACE>
ошоноб	O SH EH N EH P <SPACE>
ошоо	O SH OOh <SPACE>
ошоогүй	O SH OOh Gr UIs <SPACE>
ошохо	O SH EH H EH <SPACE>
ошохоб	O SH EH H EH P <SPACE>
ошоходоо	O SH EH H EH D OOh <SPACE>
ошоходош	O SH EH H EH D EH SH <SPACE>
ошоһон	O SH EH HH EH NG <SPACE>
оюна	O J Uh N EH <SPACE>
оюун	O J UUh NG <SPACE>
оюутад	O J UUh T EH T <SPACE>
оюутан	O J UUh T EH NG <SPACE>
оёорто	O J OOh R T EH <SPACE>
павел	P A VJ EH L <SPACE>
пакистан	P A KJ I S T A NG <SPACE>
парти	P A R TJ I <SPACE>
пашту	P A SH T Uh <SPACE>
пеккин	P E KJ I NG <SPACE>
пеккинэй	PJ E KJ I N EE <SPACE>
пеккэ	PJ E K K E <SPACE>
пенсидэ	PJ E N SJ I D EH <SPACE>
печени	PJ E CH E NJ I <SPACE>
писаницы	PJ I S A NJ I C Y <SPACE>
питер	PJ I TJ E R <SPACE>
пластик	P L A S TJ I K <SPACE>
платитай	P L A TJ I T EE <SPACE>
поездруу	P O J E Z D R UUh <SPACE>
полис	P O LJ I S <SPACE>
полисоо	P O LJ I S OOh <SPACE>
полнометражный	P O L N EH MJ EH T R A ZH N Y J <SPACE>
португал	P O R T Uh Gr A L <SPACE>
почтальоноор	P O CH T A LJ O N OOh R <SPACE>
почтыень	P O CH T Y J EH NJ <SPACE>
поэдүүд	P O E D UUs T <SPACE>
поэзии	P O E ZJ II <SPACE>
поэзиин	P O E ZJ II NG <SPACE>
поэт	P O E T <SPACE>
правин	P R A VJ I NG <SPACE>
практикада	P R A K TJ I K EH D EH <SPACE>
премьерын	P RJ E MJ J EH R Y NG <SPACE>
премьерэ	P RJ E MJ J EH R EH <SPACE>
премьерээр	P RJ E MJ J EH R EE R <SPACE>
программа	P R O G R A M M EH <SPACE>
программаар	P R O G R A M M AA R <SPACE>
программада	P R O G R A M M EH D EH <SPACE>
программар	P R O G R A M M A R <SPACE>
продюсер	P R O DJ Uh SJ E R <SPACE>
проект	P R O J EH K T <SPACE>
проектнүүдые	P R O J EH K T N UUh D Y J EH <SPACE>
проектые	P R O J EH K T Y J EH <SPACE>
проектын	P R O J EH K T Y NG <SPACE>
протасоватай	P R O T A S O V A T EE <SPACE>
профессор	P R O FJ E S S EH R <SPACE>
путкинооткэ	P Uh T KJ I N OOh T K EH <SPACE>
путкинотко	P Uh T KJ I N O T K O <SPACE>
пушкин	P Uh SH KJ I NG <SPACE>
пүмпөөдэһөөнь	P Us M P OOs D EH HH OOs NJ <SPACE>
раднаев	R A D N A J EH F <SPACE>
раднаева	R A D N A J EH V A <SPACE>
раднажап	R A D N A ZH EH P <SPACE>
раиса	R A I S A <SPACE>
районогой	R A J OOh N EH Gr EE <SPACE>
ракшаева	R A K SH A J E V A <SPACE>
раскадровщигоор	R A S K A D R O F SCH I Gr OOh R <SPACE>
режима	RJ E ZH Y M EH <SPACE>
режиссёр	RJ E ZH Y S SJ OOh R <SPACE>
режиссёрнуудтай	RJ E ZH Y S SJ OOh R N UUh T T EE <SPACE>
режиссёрой	RJ E ZH Y S SJ OOh R EE <SPACE>
рекламна	RJ E K L A M N EH <SPACE>
репетиторнүүд	RJ E PJ E TJ I T O R N UUh T <SPACE>
республика	RJ E S P Uh B LJ I K EH <SPACE>
республикымнай	RJ E S P Uh B LJ I K Y M N EE <SPACE>
республикын	RJ E S P Uh B LJ I K Y NG <SPACE>
ринчинович	RJ I N CH I N O VJ I CH <SPACE>
ринчиновичэй	RJ I N CH I N O VJ I CH EE <SPACE>
ринчиногой	RJ I N CH I N O Gr EE <SPACE>
родионовна	R O DJ I O N O V N A <SPACE>
роза	R O Z EH <SPACE>
ролигуудые	R O LJ I Gr UUh D Y J EH <SPACE>
роман	R O M A NG <SPACE>
росси	R O S SJ I <SPACE>
россиин	R O S SJ II NG <SPACE>
руу	R UUh <SPACE>
саада	S AA D EH <SPACE>
саана	S AA N EH <SPACE>
саашаа	S AA SH AA <SPACE>
саашадаа	S AA SH EH D AA <SPACE>
саашань	S AA SH EH NJ <SPACE>
сабшалга	S A P SH EH L Gr EH <SPACE>
саг	S A K <SPACE>
сагаалганай	S A Gr AA L Gr EH N EE <SPACE>
сагаан	S A Gr AA NG <SPACE>
сагай	S A Gr EE <SPACE>
сагаймни	S A Gr EE M NJ I <SPACE>
сагдаанар	S A G D AA N EH R <SPACE>
сагни	S A G NJ I <SPACE>
сагта	S A G T EH <SPACE>
сагһаа	S A G HH AA <SPACE>
садхалан	S A D H EH L EH NG <SPACE>
сай	S EE <SPACE>
сайлуулжа	S EE L UUh L ZH EH <SPACE>
сайт	S EE T <SPACE>
сакья	S A KJ J AA <SPACE>
санагын	S A N EH Gr Y NG <SPACE>
санда	S A N D EH <SPACE>
санданов	S A N D A N O V <SPACE>
санжа	S A N ZH EH <SPACE>
санжиевна	S A N ZH Y J EH V N A <SPACE>
санжимитупов	S A N ZH Y MJ I T Uh P O F <SPACE>
сара	S A R EH <SPACE>
сараа	S A R AA <SPACE>
сарьдаг	S A RJ D EH K <SPACE>
сарюун	S A RJ UUh NG <SPACE>
сахаяхадай	S A H A J EH H EH D EE <SPACE>
сахижа	S A HJ I ZH EH <SPACE>
сахихаяа	S A HJ I H EH J AA <SPACE>
сая	S A J A <SPACE>
саяан	S A J AA NG <SPACE>
саяанайм	S A J AA N EE M <SPACE>
саян	S A J A NG <SPACE>
саһанай	S A HH EH N EE <SPACE>
светлана	S VJ E T L A N EH <SPACE>
секретаревич	SJ E K RJ E T A RJ E VJ I CH <SPACE>
секундын	SJ E K Uh N D Y NG <SPACE>
секцидэ	SJ E K C Y D EH <SPACE>
семеновой	SJ E MJ O N O V EE <SPACE>
сентябриин	SJ E N TJ A B RJ II NG <SPACE>
сибириин	SJ I BJ I RJ II NG <SPACE>
сибирь	SJ I BJ I RJ <SPACE>
сиддарта	SJ I D D A R T EH <SPACE>
сингапур	SJ I N G A P Uh R <SPACE>
сингх	SJ I N K H <SPACE>
смигэй	S MJ I Gr EE <SPACE>
совет	S O VJ E T <SPACE>
советскэ	S O VJ E T S K EH <SPACE>
совхозой	S O F H O Z EE <SPACE>
совхозуудай	S O F H O Z UUh D EE <SPACE>
согтохангил	S O K T EH H A N GJ I L <SPACE>
солбон	S O L V EH NG <SPACE>
солист	S O LJ I S T <SPACE>
солонгос	S O L EH NG G EH S <SPACE>
солотой	S O L EH T EE <SPACE>
сонгоол	S O NG G OOh L <SPACE>
сонимнай	S O NJ I M N EE <SPACE>
сониндо	S O NJ I N D EH <SPACE>
сониной	S O NJ I N EE <SPACE>
соностохо	S O N EH S T EH H EH <SPACE>
соносхолнууд	S O N EH S H EH L N UUh T <SPACE>
сонхоной	S O N H EH N EE <SPACE>
сонхонуудые	S O N H EH N UUh D Y J EH <SPACE>
сонхоор	S O N H OOh R <SPACE>
сонхын	S O N H Y NG <SPACE>
сонь	S O NJ <SPACE>
соо	S OOh <SPACE>
соогоо	S OOh Gr OOh <SPACE>
соогуур	S OOh Gr UUh R <SPACE>
соомнай	S OOh M N EE <SPACE>
соонь	S OOh NJ <SPACE>
соошоогоо	S OOh SH OOh Gr OOh <SPACE>
соошье	S OOh SH J EH <SPACE>
сооһоонь	S OOh HH OOh NJ <SPACE>
соробхилно	S O R EH F HJ I L N EH <SPACE>
сохи	S O HJ I <SPACE>
сохилго	S O HJ I L Gr EH <SPACE>
сохом	S O H EH M <SPACE>
сошоолгоо	S O SH OOh L Gr OOh <SPACE>
союзай	S O J Uh Z EE <SPACE>
соёл	S O J O L <SPACE>
соёлдо	S O J O L D EH <SPACE>
соёлма	S O J O L M A <SPACE>
соёлнуудай	S O J O L N UUh D EE <SPACE>
соёлой	S O J O L EE <SPACE>
соёлоор	S O J O L OOh R <SPACE>
соёлтой	S O J O L T EE <SPACE>
спорт	S P O R T <SPACE>
спортдо	S P O R T D EH <SPACE>
спортын	S P O R T Y NG <SPACE>
сссрэй	S S S R EE <SPACE>
степанович	S TJ E P A N O VJ I CH <SPACE>
строгого	S T R O Gr O Gr EH <SPACE>
студи	S T Uh DJ I <SPACE>
субарга	S Uh V EH R Gr EH <SPACE>
субаһан	S Uh V EH HH EH NG <SPACE>
суг	S Uh K <SPACE>
суглаанда	S Uh G L AA N D EH <SPACE>
суглуулагдамал	S Uh G L UUh L EH G D EH M EH L <SPACE>
суглуулагдана	S Uh G L UUh L EH G D EH N EH <SPACE>
суглуулагдаһан	S Uh G L UUh L EH G D EH HH EH NG <SPACE>
суглуулбари	S Uh G L UUh L V EH RJ I <SPACE>
суглуулдаг	S Uh G L UUh L D EH K <SPACE>
суглуулжа	S Uh G L UUh L ZH EH <SPACE>
сультимова	S Uh LJ TJ I M O V A <SPACE>
сурбалжалагша	S Uh R V EH L ZH EH L EH K SH EH <SPACE>
сурбалжалагшатай	S Uh R V EH L ZH EH L EH K SH EH T EE <SPACE>
суулга	S UUh L Gr EH <SPACE>
суулгада	S UUh L Gr EH D EH <SPACE>
суулгаһаа	S UUh L Gr EH HH AA <SPACE>
суулгын	S UUh L Gr Y NG <SPACE>
суурхадаг	S UUh R H EH D EH K <SPACE>
сууряан	S UUh RJ AA NG <SPACE>
суута	S UUh T EH <SPACE>
суутай	S UUh T EE <SPACE>
сухалдуулаа	S Uh H EH L D UUh L AA <SPACE>
сухарихагүй	S Uh H EH RJ I H EH Gr UIs <SPACE>
сшагай	S SH A Gr EE <SPACE>
сэбэр	S E V EH R <SPACE>
сэбэрлэлгэ	S E V EH R L EH L Gr EH <SPACE>
сэбэрлэлтэ	S E V EH R L EH L T EH <SPACE>
сэгнэдэг	S E G N EH D EH K <SPACE>
сэгнэлтэ	S E G N EH L T EH <SPACE>
сэгнэлтэдэ	S E G N EH L T EH D EH <SPACE>
сэгнэлтэнүүдые	S E G N EH L T EH N UUs D Y J EH <SPACE>
сэдьхэл	S E DJ H EH L <SPACE>
сэдьхэлдэ	S E TJ H EH L D EH <SPACE>
сэдьхэлдэм	S E TJ H EH L D EH M <SPACE>
сэдьхэлдээ	S E TJ H EH L D EE <SPACE>
сэдьхэлни	S E TJ H EH L NJ I <SPACE>
сэдьхэлтэй	S E TJ H EH L T EE <SPACE>
сэдьхэлшни	S E TJ H EH L SH NJ I <SPACE>
сэдьхэлэй	S E TJ H EH L EE <SPACE>
сэдьхэлэйнгээ	S E TJ H EH L EE NG G EE <SPACE>
сэдьхэлээ	S E TJ H EH L EE <SPACE>
сэдьхэлээрээ	S E TJ H EH L EE R EE <SPACE>
сэлэнгын	S E L EH NG G Y NG <SPACE>
сэнтэй	S E N T EE <SPACE>
сэнтэйб	S E N T EE P <SPACE>
сэрэгшэн	S E R EH K SH EH NG <SPACE>
сэрэгэй	S E R EH Gr EE <SPACE>
сэсэг	S E S EH G <SPACE>
сэсэгые	S E S EH Gr Y J EH <SPACE>
сэсэгэй	S E S EH Gr EE <SPACE>
сэсэгүүдэй	S E S EH Gr UUs D EE <SPACE>
сэсэн	S E S EH NG <SPACE>
сэсэрлиг	S E S EH R LJ I K <SPACE>
сэсэрлигтэ	S E S EH R LJ I K T EH <SPACE>
сэхыень	S E H Y J EH NJ <SPACE>
сэхынь	S E H Y NJ <SPACE>
сэхэ	S E H EH <SPACE>
сүлдэ	S Us L D EH <SPACE>
сүлэй	S Us L EE <SPACE>
сүлөө	S Us L OOs <SPACE>
сүлөөгүй	S Us L OOs Gr UIs <SPACE>
сүлөөтэйгөөр	S Us L OOs T EE Gr OOs R <SPACE>
сүм	S Us M <SPACE>
та	T A <SPACE>
таабайн	T AA V EE NG <SPACE>
таалаха	T AA L EH H EH <SPACE>
тааруу	T AA R UUh <SPACE>
тааруулжа	T AA R UUh L ZH EH <SPACE>
таба	T A V EH <SPACE>
табан	T A V EH NG <SPACE>
табанай	T A V EH N EE <SPACE>
табибагүй	T A VJ I V EH Gr UIs <SPACE>
табигдаа	T A VJ I G D AA <SPACE>
табигданхай	T A VJ I G D EH N H EE <SPACE>
табигдаһаан	T A VJ I G D EH HH AA NG <SPACE>
табигдаһан	T A VJ I G D EH HH EH NG <SPACE>
табигшад	T A VJ I K SH EH T <SPACE>
табидаг	T A VJ I D EH K <SPACE>
табижа	T A VJ I ZH EH <SPACE>
табилсаа	T A VJ I L S AA <SPACE>
табимаар	T A VJ I M AA R <SPACE>
табиха	T A VJ I H EH <SPACE>
табихаш	T A VJ I H EH SH <SPACE>
табихаһаа	T A VJ I H EH HH AA <SPACE>
табиһан	T A VJ I HH EH NG <SPACE>
табяа	T A VJ AA <SPACE>
таисия	T A I SJ I J A <SPACE>
тайвань	T A J V A NJ <SPACE>
тайзан	T EE Z EH NG <SPACE>
тайланд	T A J L A N D <SPACE>
тайлбарилаатай	T EE L V EH RJ I L AA T EE <SPACE>
тайлбарилха	T EE L V EH RJ I L H EH <SPACE>
тайлга	T EE L Gr EH <SPACE>
тайлган	T EE L Gr EH NG <SPACE>
тайна	T EE N EH <SPACE>
тала	T A L EH <SPACE>
талаан	T A L AA NG <SPACE>
талаангаа	T A L AA NG G AA <SPACE>
талааниинь	T A L AA NJ II NJ <SPACE>
талаантай	T A L AA N T EE <SPACE>
талаар	T A L AA R <SPACE>
талаараа	T A L AA R AA <SPACE>
таладань	T A L EH D EH NJ <SPACE>
талаһаа	T A L EH HH AA <SPACE>
талаһаань	T A L EH HH AA NJ <SPACE>
талисман	T A LJ I S M A NG <SPACE>
талмайн	T A L M EE NG <SPACE>
талхатай	T A L H EH T EE <SPACE>
талые	T A L Y J EH <SPACE>
талын	T A L Y NG <SPACE>
тамирай	T A MJ I R EE <SPACE>
таммиинэн	T A M MJ II N E NG <SPACE>
тамминэн	T A M MJ I N E NG <SPACE>
тамминэни	T A M MJ I N E NJ I <SPACE>
танай	T A N EE <SPACE>
тангадай	T A NG G EH D EE <SPACE>
тангатовна	T A NG G A T O V N A <SPACE>
тангатовнагай	T A NG G A T O V N A Gr EE <SPACE>
танда	T A N D EH <SPACE>
таниие	T A NJ I J EH <SPACE>
танил	T A NJ I L <SPACE>
танилсаа	T A NJ I L S AA <SPACE>
танилсаабди	T A NJ I L S AA B DJ I <SPACE>
танилсаад	T A NJ I L S AA T <SPACE>
танилсалга	T A NJ I L S EH L Gr EH <SPACE>
танилсаха	T A NJ I L S EH H EH <SPACE>
танилсаһан	T A NJ I L S EH HH EH NG <SPACE>
танилсуулаа	T A NJ I L S UUh L AA <SPACE>
танилсуулха	T A NJ I L S UUh L H EH <SPACE>
танхим	T A N HJ I M <SPACE>
тараадаг	T A R AA D EH K <SPACE>
тарааха	T A R AA H EH <SPACE>
тараашад	T A R AA SH EH T <SPACE>
тараашадбди	T A R AA SH EH D B DJ I <SPACE>
тараһан	T A R EH HH EH NG <SPACE>
тарбагатайская	T A R B A G A T A J S K A J A <SPACE>
тарган	T A R Gr EH NG <SPACE>
тартай	T A R T EE <SPACE>
таряалан	T A RJ AA L EH NG <SPACE>
таряаша	T A RJ AA SH EH <SPACE>
татаа	T A T AA <SPACE>
татаарнууд	T A T AA R N UUh T <SPACE>
татаатай	T A T AA T EE <SPACE>
татааш	T A T AA SH <SPACE>
татагдадаг	T A T EH G D EH D EH K <SPACE>
татан	T A T EH NG <SPACE>
татана	T A T EH N EH <SPACE>
татаса	T A T EH S EH <SPACE>
татаһан	T A T EH HH EH NG <SPACE>
татуулаа	T A T UUh L AA <SPACE>
татьяна	T A TJ J A N A <SPACE>
ташаба	T A SH EH V EH <SPACE>
ташажал	T A SH EH ZH EH L <SPACE>
ташалгаар	T A SH EH L Gr AA R <SPACE>
ташалганда	T A SH EH L Gr EH N D EH <SPACE>
ташуурдуулааб	T A SH UUh R D UUh L AA P <SPACE>
таһаг	T A HH EH K <SPACE>
таһагай	T A HH EH Gr EE <SPACE>
таһагта	T A HH EH G T EH <SPACE>
таһалга	T A HH EH L Gr EH <SPACE>
таһалгада	T A HH EH L Gr EH D EH <SPACE>
таһалхагүйн	T A HH EH L H EH Gr UIs NG <SPACE>
таһалһан	T A HH EH L HH EH NG <SPACE>
таһараа	T A HH AA R AA <SPACE>
таһараагүй	T A HH EH R AA Gr UIs <SPACE>
театр	TJ E A T R <SPACE>
театрай	TJ E A T R EE <SPACE>
театрайнгаа	TJ E A T R EE NG G AA <SPACE>
театрайхид	TJ E A T R EE HJ I T <SPACE>
театральна	TJ E A T R A LJ N EH <SPACE>
театрнуудай	TJ E A T R N UUh D EE <SPACE>
температура	TJ E M PJ E R A T Uh R A <SPACE>
теравада	TJ E R A V A D A <SPACE>
терапи	TJ E R A PJ I <SPACE>
технологическа	TJ E H N O L O GJ I CH EH S K EH <SPACE>
теэд	TJ EE T <SPACE>
тиигэбэл	TJ II Gr EH V EH L <SPACE>
тиигэбэшье	TJ II Gr EH V EH SH J EH <SPACE>
тиигэжэ	TJ II Gr EH ZH EH <SPACE>
тиигээд	TJ II Gr EE T <SPACE>
тиигээдшье	TJ II Gr EE D SH Y J EH <SPACE>
тиигэһээр	TJ II Gr EH HH EE R <SPACE>
тиимэ	TJ II M EH <SPACE>
тиимэл	TJ II M EH L <SPACE>
тиимэшиимэш	TJ II M EH SH J M EH SH <SPACE>
тиимэшье	TJ II M EH SH J EH <SPACE>
тиимэһээ	TJ II M EH HH EE <SPACE>
тиин	TJ II NG <SPACE>
тиихэ	T II H EH <SPACE>
тиихэдэ	TJ II H EH D EE <SPACE>
тиихэдэнь	TJ II H EH D EH NJ <SPACE>
тиихэдээ	TJ II H EH D EE <SPACE>
тиишэ	TJ II SH EH <SPACE>
тиишээ	TJ II SH EE <SPACE>
тимофей	TJ I M O FJ E J <SPACE>
тимур	TJ I M Uh R <SPACE>
тобир	T O VJ I R <SPACE>
тогооной	T O Gr OOh N EE <SPACE>
тогоошон	T O Gr OOh SH EH NG <SPACE>
тогтоол	T O K T OOh L <SPACE>
тогтоохо	T O K T OOh H EH <SPACE>
тогтохоевна	T O K T EH H O J EH V N A <SPACE>
тогтошонгүй	T O K T EH SH EH N G UIs <SPACE>
тогтоһон	T O K T EH HH EH NG <SPACE>
тодорбо	T O D EH R V EH <SPACE>
тойрогой	T OE R EH Gr EE <SPACE>
тойрогоор	T OE R EH Gr OOh R <SPACE>
тойрогто	T OE R EH K T EH <SPACE>
тойроод	T OE R OOh T <SPACE>
толгойгоо	T O L Gr EE Gr OOh <SPACE>
толгойгороо	T O L Gr EE Gr O R OOh R <SPACE>
толи	T O LJ I <SPACE>
толстой	T O L S T O J <SPACE>
томо	T O M EH <SPACE>
томорхуу	T O M EH R H UUh <SPACE>
томохон	T O M EH H EH NG <SPACE>
томошуул	T O M SH UUh L <SPACE>
тон	T O NG <SPACE>
тоо	T OOh <SPACE>
тоогдонгүй	T OOh G D EH NG G UIs <SPACE>
тоогоор	T OOh Gr OOh R <SPACE>
тоодо	T OOh D EH <SPACE>
тоологдодог	T OOh L EH G D EH D EH K <SPACE>
тоонто	T OOh N T EH <SPACE>
тоонтотой	T OOh N T EH T EE <SPACE>
тоонтоёо	T OOh N T EH J OOh <SPACE>
тооһо	T OOh HH EH <SPACE>
тооһоноо	T OOh HH EH N OOh <SPACE>
тордиһогүй	T O R DJ I HH EH Gr UIs <SPACE>
тохожорхихо	T O H EH ZH E R HJ I H EH <SPACE>
тохёолдожо	T O HJ OOh L D EH ZH EH <SPACE>
тохёолдоод	T O HJ OOh L D OOh T <SPACE>
тоһо	T O HH EH <SPACE>
тоһон	T O HH EH NG <SPACE>
травоолтэ	T R A V OOh L T EH <SPACE>
трактаар	T R A K T AA R <SPACE>
трактортай	T R A K T EH R T EE <SPACE>
тренер	T RJ E NJ E R <SPACE>
тренерэйнь	T RJ E NJ E R EE NJ <SPACE>
трюгүүдые	T RJ UUh Gr UUs D Y J EH <SPACE>
тугал	T Uh Gr EH L <SPACE>
тудалдадаг	T Uh D EH L D EH D EH K <SPACE>
тудашоо	T Uh D EH SH OOh <SPACE>
туйлалта	T UIs L EH L T EH <SPACE>
туйлаһан	T UIh L EH HH EH NG <SPACE>
тула	T Uh L EH <SPACE>
тулада	T Uh L EH D EH <SPACE>
тулалдаанай	T Uh L EH L D AA N EE <SPACE>
туласа	T Uh L EH S EH <SPACE>
тунгалаг	T Uh NG G EH L EH K <SPACE>
тунгус	T Uh NG G Uh S <SPACE>
тура	T Uh R EH <SPACE>
туркада	T Uh R K EH D EH <SPACE>
туркуһаань	T Uh R K Uh HH AA NJ <SPACE>
турша	T Uh R SH EH <SPACE>
туршагты	T Uh R SH EH K T Y <SPACE>
туршада	T Uh R SH EH D EH <SPACE>
туршажа	T Uh R SH EH ZH EH <SPACE>
туршаха	T Uh R SH EH H EH <SPACE>
тус	T Uh S <SPACE>
тусда	T Uh S D EH <SPACE>
тухай	T Uh H EE <SPACE>
тухайгаа	T Uh H EE Gr AA <SPACE>
тухайм	T Uh H EE M <SPACE>
туяа	T Uh J AA <SPACE>
туһа	T Uh HH EH <SPACE>
туһаар	T Uh HH AA R <SPACE>
туһалалсаа	T Uh HH EH L EH L S AA <SPACE>
туһаламжа	T Uh HH EH L EH M ZH EH <SPACE>
туһаламжанууд	T Uh HH EH L EH M ZH EH N UUh T <SPACE>
туһалдаг	T Uh HH EH L D EH K <SPACE>
туһалжа	T Uh HH EH L ZH EH <SPACE>
туһалсажа	T Uh HH EH L S EH ZH EH <SPACE>
туһалха	T Uh HH EH L H EH <SPACE>
туһалхые	T Uh HH EH L H Y J EH <SPACE>
туһатай	T Uh HH EH T EE <SPACE>
туһаяа	T Uh HH EH J AA <SPACE>
тысяча	T Y SJ A CH A <SPACE>
тэбэрихэ	T E V EH RJ I H EH <SPACE>
тэгшэ	T E K SH EH <SPACE>
тэдхэмжэ	T E T H EH M ZH EH <SPACE>
тэдэ	T E D EH <SPACE>
тэдэмнай	T E D EH M N EE <SPACE>
тэдэнэй	T E D EH N EE <SPACE>
тэдэнэйнь	T E D EH N EE NJ <SPACE>
тэдэнэр	T E D EH N EH R <SPACE>
тэдэнэрэй	T E D EH N EH R EE <SPACE>
тэдэнээ	T E D EH N EE <SPACE>
тэдээндэ	T E D EE N D EH <SPACE>
тэдээнтэй	T E D EE N T EE <SPACE>
тэжээ	T E ZH EE <SPACE>
тэжээгты	T E ZH EE K T Y <SPACE>
тэжээхэ	T E ZH EE H EH <SPACE>
тэжээхэеэ	T E ZH EE H EH J EE <SPACE>
тэмдэглэдэг	T E M D EH G L EH D EH K <SPACE>
тэмдэглэмээр	T E M D EH G L EH M EE R <SPACE>
тэмдэглээ	T E M D EH G L EE <SPACE>
тэмдэглэһээр	T E M D EH G L EH HH EE R <SPACE>
тэмсээн	T E M S EE NG <SPACE>
тэнгисэй	T E NG GJ I S EE <SPACE>
тэнгэриин	T E NG G EH RJ II NG <SPACE>
тэндэ	T E N D EH <SPACE>
тэндэмни	T E N D EH M NJ I <SPACE>
тэндэнь	T E N D EH NJ <SPACE>
тэндэхи	T E N D EH HJ I <SPACE>
тэниидэг	T E NJ II D EH K <SPACE>
тэнюун	T E NJ UUh NG <SPACE>
тэригүүн	T E RJ I Gr UUs NG <SPACE>
тэрьедээд	T E RJ J E D EE T <SPACE>
тэрэ	T E R EH <SPACE>
тэрэмни	T E R EH M NJ I <SPACE>
тэрэниие	T E R EH NJ II J EH <SPACE>
тэрэнтэй	T E R EH N T EE <SPACE>
тэрэнэй	T E R EH N EE <SPACE>
тэрэнээ	T E R EH N EE <SPACE>
тэрэшни	T E R EH SH NJ I <SPACE>
тэрээн	T E R EE NG <SPACE>
тэрээндэ	T E R EE N D EH <SPACE>
тэрээндэнь	T E R EE N D EH NJ <SPACE>
тэрээниие	T E R EE NJ II J EH <SPACE>
тэрээнһээ	T EH R EE N HH EE <SPACE>
тэрээхэнэй	T E R EE H EH N EE <SPACE>
тэсэмгэй	T E S EH M Gr EE <SPACE>
тээ	T EE <SPACE>
тээшэ	T EE SH EH <SPACE>
түб	T Us P <SPACE>
түби	T Us VJ I <SPACE>
түбхинэһэн	T Us P HJ I N EH HH EH NG <SPACE>
түбхинөө	T Us P HJ I N OOs <SPACE>
түбэй	T Us V EE <SPACE>
түбүүдһээ	T Us V UUs D HH EE <SPACE>
түгнын	T Us G N Y NG <SPACE>
түгнынгөө	T Us G N Y NG G OOs <SPACE>
түгэлдэр	T Us Gr EH L D EH R <SPACE>
түгэсхэлэй	T Us Gr EH S H EH L EE <SPACE>
түгэсэбэ	T Us Gr EH S EH V EH <SPACE>
түлбэри	T Us L V EH RJ I <SPACE>
түлеэ	T Us LJ EE <SPACE>
түлхюур	T Us L HJ UUh R <SPACE>
түлөө	T Us L OOs <SPACE>
түлөөлэгшэд	T Us L OOs L EH K SH EH T <SPACE>
түлөөһэгүйгөөр	T Us L OOs HH EH Gr UIs Gr OOs R <SPACE>
түмэр	T Us M EH R <SPACE>
түмүрид	T Us M Us RJ I T <SPACE>
түнхэн	T Us N H EH NG <SPACE>
түнхэнэй	T Us N H EH N EE <SPACE>
түргэ	T Us R Gr EH <SPACE>
түргэн	T Us R Gr EH NG <SPACE>
түргэнөөр	T Us R Gr EH N OOs R <SPACE>
түргэхэнөөр	T Us R Gr EH H EH N OOs R <SPACE>
түрхидэг	T Us R HJ I D EH K <SPACE>
түрын	T Us R Y NG <SPACE>
түрэ	T Us R EH <SPACE>
түрэл	T Us R EH L <SPACE>
түрэлнүүд	T Us R EH L N UUh T <SPACE>
түрэлхид	T Us R EH L HJ I D <SPACE>
түрэлхидтэеэ	T Us R EH L HJ I T T E J EE <SPACE>
түрэхэһөө	T Us R EH H EH HH OOs <SPACE>
түрэһэн	T Us R EH HH EH NG <SPACE>
түрэһэнэй	T Us R EH HH EH N EE <SPACE>
түрүү	T Us R UUs <SPACE>
түрүүл	T Us R UUs L <SPACE>
түрүүлжэ	T Us R UUs L ZH EH <SPACE>
түрүүлнэ	T Us R UUs L N EH <SPACE>
түрүүлэгшэ	T Us R UUs L EH K SH EH <SPACE>
түрүүн	T Us R UUs NG <SPACE>
түрүүтэй	T Us R UUs T EE <SPACE>
түрүүшын	T Us R UUs SH Y NG <SPACE>
түрүүшынхеэ	T Us R UUs SH Y N HJ EE <SPACE>
түрүүшынхиеэ	T Us R UUs SH Y N HJ I J EE <SPACE>
түрүүшээр	T Us R UUs SH EE R <SPACE>
түрүүшүүлэй	T Us R UUs SH UUs L EE <SPACE>
түрөө	T Us R OOs <SPACE>
түсэб	T Us S EH P <SPACE>
түсэбүүд	T Us S EH V UUs T <SPACE>
түхэл	T Us H EH L <SPACE>
түхэлөөр	T Us H EH L OOs R <SPACE>
түхэм	T Us H EH M <SPACE>
түхөөбэ	T Us H OOs B EH <SPACE>
түүлөөбди	T UUs L OOs B DJ I <SPACE>
түүхэ	T UUs H EH <SPACE>
түүхэдэ	T UUs H EH D EE <SPACE>
түүхэй	T UUs H EE <SPACE>
түүхэтэ	T UUs H EH T EH <SPACE>
түүхэтэй	T UUs H EH T EE <SPACE>
убушеевичай	Uh V Uh SH E J E VJ I CH EE <SPACE>
уг	Uh K <SPACE>
угаа	Uh Gr AA <SPACE>
угаараа	Uh Gr AA R AA <SPACE>
угай	Uh Gr EE <SPACE>
угайм	Uh Gr EE M <SPACE>
угтагдаа	Uh K T EH G D AA <SPACE>
угтагдажа	Uh K T EH G D EH ZH EH <SPACE>
угтадаг	Uh K T EH D EH K <SPACE>
угтажа	Uh T K EH ZH EH <SPACE>
угтан	Uh K T EH NG <SPACE>
угтахань	Uh K T EH H EH NJ <SPACE>
угтаһан	Uh K T EH HH EH NG <SPACE>
угуудай	Uh Gr UUh D EE <SPACE>
угһаа	Uh G HH AA <SPACE>
удаа	Uh D AA <SPACE>
удаан	Uh D AA NG <SPACE>
удаань	Uh D AA NJ <SPACE>
удаахан	Uh D AA H EH NG <SPACE>
удаганай	Uh D EH Gr EH N EE <SPACE>
уданшьегүй	Uh D EH NG SH J EH Gr UIs <SPACE>
ударидалгатай	Uh D EH RJ I D EH L Gr EH T EE <SPACE>
удахагүй	Uh D EH H EH Gr UIs <SPACE>
удха	Uh T H EH <SPACE>
удхатай	Uh T H EH T EE <SPACE>
уйгуурнууд	UIh Gr UUh R N UUh T <SPACE>
уйлана	UIh L EH N EH <SPACE>
улаан	Uh L AA NG <SPACE>
улаанүдын	Uh L AA N Us D Y NG <SPACE>
улаанүдэ	Uh L AA N Us D EH <SPACE>
улаанүдэдэ	Uh L AA N Us D EH D EH <SPACE>
уладууд	Uh L EH D UUh T <SPACE>
улам	Uh L EH M <SPACE>
улан	Uh L EH NG <SPACE>
уларилтай	Uh L EH RJ I L T EE <SPACE>
улас	Uh L EH S <SPACE>
уласай	Uh L EH S EE <SPACE>
уласта	Uh L EH S T EH <SPACE>
уласуудта	Uh L EH S UUh T T EH <SPACE>
уласхоорондын	Uh L EH S H OOh R EH N D Y NG <SPACE>
уласые	Uh L EH S Y J EH <SPACE>
унаган	Uh N EH Gr EH NG <SPACE>
уналга	Uh N EH L Gr EH <SPACE>
унахадань	Uh N EH H EH D EH NJ <SPACE>
ундалжа	Uh N D EH L ZH EH <SPACE>
университедэй	Uh NJ I VJ E R SJ I TJ E D EE <SPACE>
университет	Uh NJ I VJ E R SJ I TJ E T <SPACE>
унталгын	Uh N T EH L Gr Y NG <SPACE>
уншааб	Uh N SH AA P <SPACE>
уншаад	Uh N SH AA T <SPACE>
уншагшадай	Uh N SH EH K SH EH D EE <SPACE>
уншагшадтаа	Uh N SH EH K SH EH T T AA <SPACE>
уншагшадтаяа	Uh N SH EH K SH EH T T EH J AA <SPACE>
уншагшадые	Uh N SH EH K SH EH D Y J EH <SPACE>
уншадаг	Uh N SH EH D EH K <SPACE>
уншана	Uh N SH EH N EH <SPACE>
уншаха	Uh N SH EH H EH <SPACE>
уншаһан	Uh N SH EH HH EH NG <SPACE>
урагшаа	Uh R EH G SH AA <SPACE>
урагшань	Uh R EH K SH EH NJ <SPACE>
урагшатай	Uh R EH G SH EH T EE <SPACE>
уран	Uh R EH NG <SPACE>
уранаар	Uh R EH N AA R <SPACE>
урбашагүй	Uh R V EH SH EH Gr UIs <SPACE>
ургалта	Uh R Gr EH L T EH <SPACE>
ургамал	Uh R Gr EH M EH L <SPACE>
урган	Uh R Gr EH NG <SPACE>
ургы	Uh R Gr Y <SPACE>
ургыхан	Uh R Gr Y H EH NG <SPACE>
урда	Uh R D EH <SPACE>
урдаа	Uh R D AA <SPACE>
урданай	Uh R D EH N EE <SPACE>
урданайнгаа	Uh R D EH N EE NG G AA <SPACE>
урдуулаагүй	Uh R D UUh L AA Gr UIs <SPACE>
урдын	Uh R D Y NG <SPACE>
урид	Uh RJ I T <SPACE>
уридаг	Uh RJ I D EH K <SPACE>
урижа	Uh RJ I ZH EH <SPACE>
урин	Uh RJ I NG <SPACE>
урихадань	Uh RJ I H EH D EH NJ <SPACE>
урихан	Uh RJ I H EH NG <SPACE>
уриһан	Uh RJ I HH EH NG <SPACE>
урматай	Uh R M EH T EE <SPACE>
уряа	Uh RJ AA <SPACE>
уряална	Uh RJ AA L N EH <SPACE>
усалталгада	Uh S EH L T EH L Gr EH D EH <SPACE>
устьордада	Uh S TJ O R D A D EH <SPACE>
устьордын	Uh S TJ O R D Y NG <SPACE>
ута	Uh T EH <SPACE>
утаһаар	Uh T A HH AA R <SPACE>
утаһые	Uh T A HH Y J EH <SPACE>
уужа	UUh ZH EH <SPACE>
уужамаар	UUh ZH EH M AA R <SPACE>
уула	UUh L EH <SPACE>
уулада	UUh L EH D EH <SPACE>
уулархаг	UUh L EH R H EH K <SPACE>
уулаяа	UUh L A J AA <SPACE>
уулаһаашье	UUh L EH HH AA SH J EH <SPACE>
уулзаа	UUh L Z AA <SPACE>
уулзажа	UUh L Z EH ZH EH <SPACE>
уулзалга	UUh L Z EH L Gr EH <SPACE>
уулзахадаа	UUh L Z EH H EH D AA <SPACE>
уулзаһан	UUh L Z EH HH EH NG <SPACE>
уулын	UUh L Y NG <SPACE>
ухаагаараа	Uh H AA Gr AA R AA <SPACE>
ухаан	Uh H AA NG <SPACE>
ухаанай	Uh H AA N EE <SPACE>
ухаандаа	Uh H AA N D AA <SPACE>
ухаантай	Uh H AA N T EE <SPACE>
ухаатай	Uh H AA T EE <SPACE>
училищи	Uh CH I LJ I SCH I <SPACE>
училищида	Uh CH I LJ I SCH I D EH <SPACE>
училищиин	Uh CH I LJ I SCH I NG <SPACE>
училищияа	Uh CH I LJ I SCH I J AA <SPACE>
ушар	Uh SH EH R <SPACE>
ушаралай	Uh SH EH R EH L EE <SPACE>
ушарнууд	Uh SH EH R N UUh T <SPACE>
ушарнуудаар	Uh SH EH R N UUh D AA R <SPACE>
ушарнуудтай	Uh SH EH R N UUh T T EE <SPACE>
ушартаа	Uh SH EH R T AA <SPACE>
уялга	Uh J EH L Gr EH <SPACE>
уялгалха	Uh J EH L Gr EH L H EH <SPACE>
уялгата	Uh J EH L Gr EH T EH <SPACE>
уян	Uh J A NG <SPACE>
уянгатайгаар	Uh J A NG Gr EH T EE Gr AA R <SPACE>
уянгые	Uh J A NG G Y J EH <SPACE>
уяруулна	Uh J A R UUh L N EH <SPACE>
уһа	Uh HH EH <SPACE>
уһан	Uh HH EH NG <SPACE>
уһанайнь	Uh HH EH N EE NJ <SPACE>
уһанда	Uh HH EH N D EH <SPACE>
уһатай	Uh HH EH T EE <SPACE>
факультативна	F A K Uh LJ T A TJ I V N EH <SPACE>
факультедтэ	F A K Uh LJ TJ EH T T EH <SPACE>
фермернүүд	FJ E R MJ EH R N UUs T <SPACE>
фермернүүдтэ	FJ E R MJ EH R N UUs T T EH <SPACE>
фестивалиин	FJ E S TJ I V A LJ II NG <SPACE>
фестивальнуудта	FJ E S TJ I V A LJ N UUh T T EH <SPACE>
физическэ	FJ I ZJ I CH E S K EH <SPACE>
философско	FJ I L O S O F S K EH <SPACE>
фильм	FJ I LJ M <SPACE>
фильмнүүдые	FJ I LJ M N UUs D Y J EH <SPACE>
финляндиин	FJ I N LJ A N DJ II NG <SPACE>
флодой	F L O D EE <SPACE>
фм	EH F EH M <SPACE>
фольклорно	F O LJ K LJ O R N EH <SPACE>
фонтан	F O N T A NG <SPACE>
фото	F O T EH <SPACE>
францида	F R A N C Y D EH <SPACE>
франциин	P R A N C Y NG <SPACE>
француз	F R A N C Us S <SPACE>
ха	H A <SPACE>
хаагаа	H AA Gr AA <SPACE>
хаагданхай	H AA G D EH N H EE <SPACE>
хаажа	H AA ZH EH <SPACE>
хаан	H AA NG <SPACE>
хаана	H AA N EH <SPACE>
хаанабииб	H AA N EH VJ II P <SPACE>
хаанабши	H AA N EH P SH Y <SPACE>
хаанай	H AA N EE <SPACE>
хаанахи	H AA N EH HJ I <SPACE>
хаанашье	H AA N EH SH J EH <SPACE>
хаанаһаа	H AA N EH HH AA <SPACE>
хаашаг	H AA SH EH K <SPACE>
хаашагай	H AA SH EH Gr EE <SPACE>
хаашагһаа	H AA SH EH G HH AA <SPACE>
хаба	H A V EH <SPACE>
хабаадаа	H A V AA D AA <SPACE>
хабаадагшадые	H A V AA D EH K SH EH D Y J EH <SPACE>
хабаададаг	H A V AA D EH D EH K <SPACE>
хабаададагбди	H A V AA D EH D EH G B DJ I <SPACE>
хабаададагта	H A V AA D EH D EH K T EH <SPACE>
хабаадажа	H A V AA D EH ZH EH <SPACE>
хабаадалгаар	H A V AA D EH L Gr AA R <SPACE>
хабаадалсаһан	H A V AA D EH L S EH HH EH NG <SPACE>
хабаадана	H A V AA D EH N EH <SPACE>
хабаадуулхада	H A V AA D UUh L H EH D EH <SPACE>
хабаатай	H A V AA T EE <SPACE>
хабарай	H A V EH R EE <SPACE>
хабсагай	H A P S EH Gr EE <SPACE>
хабсагайн	H A P S EH Gr EE NG <SPACE>
хабсагайнай	H A P S EH Gr EE N EE <SPACE>
хадаа	H A D AA <SPACE>
хадаар	H A D AA R <SPACE>
хадагалаатай	H A D EH Gr EH L AA T EE <SPACE>
хадамда	H A D EH M D EH <SPACE>
хадхан	H A T H EH NG <SPACE>
хадын	H A D Y NG <SPACE>
хажуугаар	H A ZH UUh Gr AA R <SPACE>
хажууда	H A ZH UUh D EH <SPACE>
хажуудахи	H A ZH UUh D EH HJ I <SPACE>
хазагай	H A Z EH Gr EE <SPACE>
хазармонголшууд	H A Z EH R M O NG G EH L S UUh T <SPACE>
хайшаа	H EE SH AA <SPACE>
хайшан	H EE SH EH NG <SPACE>
хайямай	H A J A M EE <SPACE>
халираа	H A LJ I R AA <SPACE>
халуун	H A L UUh NG <SPACE>
халуунаар	H A L UUh N AA R <SPACE>
хальмагуудай	H A LJ M EH Gr UUh D EE <SPACE>
хамаг	H A M EH G <SPACE>
хамагай	H A M EH Gr EE <SPACE>
хамагые	H A M EH Gr Y J EH <SPACE>
хамарханов	H A M EH R H A N O F <SPACE>
хамба	H A M B EH <SPACE>
хамгаалалдаг	H A M G AA L EH L D EH K <SPACE>
хамгаалгын	H A M Gr AA L Gr Y NG <SPACE>
хамгаалдаг	H A M G AA L D EH K <SPACE>
хамгаалха	H A M G AA L H EH <SPACE>
хамжан	H A M ZH EH NG <SPACE>
хамсыгаа	H A M S Y Gr AA <SPACE>
хамта	H A M T EH <SPACE>
хамтадхаһан	H A M T EH T H EH HH EH NG <SPACE>
хамтараад	H A M T EH R AA T <SPACE>
хамтарал	H A M T EH R EH L <SPACE>
хамһабариин	H A M HH EH V EH RJ II NG <SPACE>
хан	H A NG <SPACE>
ханада	H A N EH D EH <SPACE>
ханануудынь	H A N EH N UUh D Y NJ <SPACE>
хананхатайгаар	H A N EH N H EH T EE Gr AA R <SPACE>
хангаһангүй	H A NG G EH HH EH NG G UIs <SPACE>
хандадаг	H A N D EH D EH K <SPACE>
хандахаб	H A N D EH H EH P <SPACE>
хандуевна	H A N D Uh J E V N A P <SPACE>
хандуулдаг	H A N D UUh L D EH K <SPACE>
хани	H A NJ I <SPACE>
ханхареевнатай	H A N H EH RJ E J EH V N A T EE <SPACE>
хара	H A R EH <SPACE>
хараабди	H A R AA B DJ I <SPACE>
хараагүйб	H A R AA Gr UIs P <SPACE>
хараад	H A R AA T <SPACE>
хараада	H A R AA D EH <SPACE>
хараалагданхай	H A R AA L EH G D EH N H EE <SPACE>
хараанда	H A R AA N D EH <SPACE>
хараасгайнуудай	H A R AA S H EH N UUh D EE <SPACE>
харагдаа	H A R EH G D AA <SPACE>
харагдажа	H A R EH G D EH ZH EH <SPACE>
харагдана	H A R EH G D EH N EH <SPACE>
харагдаха	H A R EH G D EH H EH <SPACE>
харагдаһан	H A R EH G D EH HH EH NG <SPACE>
харагшад	H A R EH K SH EH T <SPACE>
харагшадаа	H A R EH K SH EH D AA <SPACE>
харагшадай	H A R EH K SH EH D EE <SPACE>
харагшадта	H A R EH K SH EH T T EH <SPACE>
харагшадтаа	H A R EH K SH EH T T AA <SPACE>
харадаг	H A R EH D EH K <SPACE>
хаража	H A R EH ZH EH <SPACE>
харалганаадануудта	H A R EH L Gr EH N AA D EH N UUs T T EH <SPACE>
харалганда	H A R EH L Gr EH N D EH <SPACE>
харамтай	H A R EH M T EE <SPACE>
харана	H A R EH N EH <SPACE>
харанаб	H A R EH N EH P <SPACE>
харанат	H A R EH N EH T <SPACE>
харандаашууд	H A R EH N D AA SH UUh T <SPACE>
харанхыда	H A R EH N H Y D EH <SPACE>
хараха	H A R EH H EH <SPACE>
харахада	H A R EH H EH D EH <SPACE>
харахан	H A R EH H EH NG <SPACE>
харахаш	H A R EH H EH SH <SPACE>
хараһан	H A R EH HH EH NG <SPACE>
харбановагай	H A R V EH N O V A Gr EE <SPACE>
харгана	H A R Gr EH N EH <SPACE>
харгы	H A R Gr Y <SPACE>
харгыгаар	H A R Gr Y Gr AA R <SPACE>
харгыдаа	H A R Gr Y D AA <SPACE>
харгыдань	H A R Gr Y D EH NJ <SPACE>
хари	H A RJ I <SPACE>
харилсаа	H A RJ I L S AA <SPACE>
харилсаан	H A RJ I L S AA NG <SPACE>
харилсажа	H A RJ I L S EH ZH EH <SPACE>
харин	H A RJ I NG <SPACE>
хартаабхын	H A R T AA P H Y NG <SPACE>
хартиков	H A R TJ I K O F <SPACE>
хартикова	H A R TJ I K O V A <SPACE>
харуулаа	H A R UUh L AA <SPACE>
харуулаад	H A R UUh L AA T <SPACE>
харуулагдана	H A R UUh L EH G D EH N EH <SPACE>
харуулагданаа	H A R UUh L EH G D EH N AA <SPACE>
харуулан	H A R UUh L EH NG <SPACE>
харуулба	H A R UUh L V EH <SPACE>
харуулжа	H A R UUh L ZH EH <SPACE>
харуулна	H A R UUh L N EH <SPACE>
харуулхадань	H A R UUh L H EH D EH NJ <SPACE>
харуулшад	H A R UUh L SH EH T <SPACE>
харуулһан	H A R UUh L HH EH NG <SPACE>
харюултай	H A RJ UUh L T EE <SPACE>
хатан	H A T EH NG <SPACE>
хатанхай	H A T EH N H EE <SPACE>
хатар	H A T EH R <SPACE>
хатараа	H A T EH R AA <SPACE>
хатарааб	H A T EH R AA P <SPACE>
хатараар	H A T EH R AA R <SPACE>
хатарай	H A T EH R EE <SPACE>
хатарба	H A T EH R V EH <SPACE>
хатардаг	H A T EH R D EH K <SPACE>
хатареев	H A T EH RJ E J EH F <SPACE>
хатаржа	H A T EH R ZH EH <SPACE>
хатарнабди	H A T EH R N EH B DJ I <SPACE>
хатарнуудые	H A T EH R N UUh D Y J EH <SPACE>
хатарта	H A T EH R T EH <SPACE>
хатарха	H A T EH R H EH <SPACE>
хатархаар	H A T EH R H AA R <SPACE>
хатархаяа	H A T EH R H EH J AA <SPACE>
хатарша	H A T EH R SH EH <SPACE>
хатаршад	H A T EH R SH EH T <SPACE>
хатаршан	H A T EH R SH EH NG <SPACE>
хатарые	H A T EH R Y J EH <SPACE>
хатарһанаа	H A T EH R HH EH N AA <SPACE>
хатууе	H A T UUh J EH <SPACE>
хахад	H A H EH T <SPACE>
хахасаха	H A H EH S EH H EH <SPACE>
хахираар	H A HJ I R AA R <SPACE>
хашардалта	H A SH EH R D EH L T EH <SPACE>
хаһаяа	H A HH EH J AA <SPACE>
хеэльсинкидэ	HJ EE LJ SJ I N K EH D EH <SPACE>
хибэс	HJ I V EH S <SPACE>
хизаар	HJ I Z AA R <SPACE>
хизаарай	HJ I Z AA R EE <SPACE>
хизаарнуудаар	HJ I Z AA R N UUh D AA R <SPACE>
хилээмэн	HJ I L EE M EH NG <SPACE>
химгадалгагша	HJ I M Gr EH D EH L Gr EH K SH EH <SPACE>
химгадалгашадшье	HJ I M Gr EH D EH L Gr EH SH EH T SH J EH <SPACE>
химгадалгын	HJ I M Gr EH D EH L Gr Y NG <SPACE>
хиртээнгүйгөөр	HJ I R T EE NG G UIs Gr OOs R <SPACE>
хирэ	HJ I R EH <SPACE>
хирээр	HJ I R EE R <SPACE>
хитад	HJ I T EH T <SPACE>
хобто	H O P T EH <SPACE>
ходо	H O D EH <SPACE>
хододоо	H O D EH D OOh <SPACE>
ходол	H O D EH L <SPACE>
хоер	H O J EH R <SPACE>
хоергэрлэнхэй	H O J EH R G E R L EH N H EE <SPACE>
хоердохи	H O J O R D EH HJ I <SPACE>
хожомдохи	H O ZH EH M D EH HJ I <SPACE>
хоймор	H OE M EH R <SPACE>
хойно	H OE N EH <SPACE>
хойноо	H OE N OOh <SPACE>
хойнохоно	H OE N EH H EH N EH <SPACE>
хойноһоо	H OE N OOh HH OOh <SPACE>
хойноһоонь	H OE N OOh HH OOh NJ <SPACE>
хойто	H OE T EH <SPACE>
хойтогол	H OE T EH Gr O L <SPACE>
хойтоголой	H OE T EH Gr O L EE <SPACE>
хойшо	H OE SH EH <SPACE>
хойшолондоо	H OE SH EH L EH N D EH <SPACE>
хойшоо	H OE H OOh <SPACE>
холбоо	H O L V OOh <SPACE>
холбоон	H O L V OOh NG <SPACE>
холбооной	H O L V OOh N EE <SPACE>
холбоотой	H O L V OOh T EE <SPACE>
холижо	H O LJ I ZH EH <SPACE>
холисогүй	H O LJ I S EH Gr UIs <SPACE>
холисолдоһон	H O LJ I S EH L D EH HH EH NG <SPACE>
холо	H O L EH <SPACE>
холодожол	H O L EH D EH ZH EH L <SPACE>
холоһоо	H O L OOh HH OOh <SPACE>
холуур	H O L UUh R <SPACE>
холын	H O L Y NG <SPACE>
хомор	H O M EH R <SPACE>
хонгёо	H O NG GJ OOh <SPACE>
хониндо	H O NJ I N D EH <SPACE>
хоног	H O N EH K <SPACE>
хоногой	H O N EH Gr EE <SPACE>
хоногто	H O N EH K T EH <SPACE>
хонхо	H O N H EH <SPACE>
хоол	H OOh L <SPACE>
хоолойтой	H OOh L EE T EE <SPACE>
хоолоор	H OOh L OOh R <SPACE>
хоолтой	H OOh L T EE <SPACE>
хоорондоо	H OOh R EH N D EH <SPACE>
хоорондын	H OOh R EH N D Y NG <SPACE>
хооһон	H OOh HH EH NG <SPACE>
хореография	H O RJ E O G R A FJ I A <SPACE>
хори	H O RJ I <SPACE>
хоридой	H O RJ I D EE <SPACE>
хориин	H O RJ II NG <SPACE>
хорин	H O RJ I NG <SPACE>
хормойдо	H O R EE D EH <SPACE>
хорогүй	H O R EH Gr UIs <SPACE>
хородог	H O R EH D EH K <SPACE>
хоротой	H O R EH T EE <SPACE>
хорхой	H O R H EE <SPACE>
хорёо	H O RJ OOh <SPACE>
хото	H O T EH <SPACE>
хотодо	H O T EH D EH <SPACE>
хотоһоо	H O T EH HH OOh <SPACE>
хотын	H O T Y NG <SPACE>
хохидоһон	H O HJ I D EH HH EH NG <SPACE>
хоёр	H O J EH R <SPACE>
хоёрдохи	H O J O R D EH HJ I <SPACE>
хубаалдаба	H Uh V AA L V EH <SPACE>
хубаалдажа	H Uh V AA L D EH ZH EH <SPACE>
хубаалдана	H Uh V AA L D EH N EH <SPACE>
хубаалдахыень	H Uh V AA L D EH H Y J EH NJ <SPACE>
хубаалдаһан	H Uh V AA L D EH HH EH NG <SPACE>
хубааралга	H Uh V AA R EH L Gr EH <SPACE>
хубаарилгаар	H Uh V AA RJ I L Gr AA R <SPACE>
хуби	H Uh VJ I <SPACE>
хубида	H Uh VJ I D EH <SPACE>
хубидань	H Uh VJ I D EH NJ <SPACE>
хубиин	H Uh VJ II NG <SPACE>
хубилалтада	H Uh VJ I L EH L T EH D T EH <SPACE>
хубилалтанууд	H Uh VJ I L EH L T EH N UUh T <SPACE>
хубилгаха	H Uh VJ I L Gr EH H EH <SPACE>
хубитаяа	H Uh VJ I T EH J AA <SPACE>
хубсаһа	H Uh P S EH HH EH <SPACE>
хубсаһадтай	H Uh P S EH HH EH T T EE <SPACE>
хубсаһан	H Uh P S EH HH EH NG <SPACE>
хубсаһанда	H Uh P S EH HH EH N D EH <SPACE>
хубсаһатаяа	H Uh P S EH HH EH T EH J AA <SPACE>
худаг	H Uh D EH K <SPACE>
худал	H Uh D EH L <SPACE>
худалдажа	H Uh D EH L ZH EH <SPACE>
хужар	H Uh ZH EH R <SPACE>
хужарлуулыт	H Uh ZH EH R L UUh L Y T <SPACE>
хулгай	H Uh L Gr EE <SPACE>
хулгайшаниие	H Uh L Gr EE SH EH NJ II J EH <SPACE>
хулинсагуудай	H Uh LJ I N S EH Gr UUh D EE <SPACE>
хулинсагуудайнгаа	H Uh LJ I N S EH Gr UUh D EE NG G AA <SPACE>
хулууда	H Uh L UUh D EH <SPACE>
хун	H Uh NG <SPACE>
хурамхаан	H Uh R EH M H AA NG <SPACE>
хурган	H Uh R Gr EH NG <SPACE>
хурдандал	H Uh R D EH N D EH L <SPACE>
хурса	H Uh R S EH <SPACE>
хурсатай	H Uh R S EH T EE <SPACE>
хурьга	H Uh RJ Gr EH <SPACE>
хуу	H UUh <SPACE>
хуубааһан	H Uh V AA HH EH NG <SPACE>
хуурай	H UUh R EE <SPACE>
хуушаранхай	H UUh SH EH R EH NG H EE <SPACE>
хушажархёо	H Uh SH EH ZH EH R HJ OOh <SPACE>
хэ	H E <SPACE>
хэблэгдэнхэй	H E B L EH G D EH N H EE <SPACE>
хэблэгдээн	H E B L EH G D EE NG <SPACE>
хэблэлдэ	H E B L EH L D EH <SPACE>
хэблэлнүүдтэ	H E B L EH L N UUs T T EH <SPACE>
хэблэлэй	H E B L EH L EE <SPACE>
хэбэ	H E V EH <SPACE>
хэбэртэй	H E V EH R T EE <SPACE>
хэгдэжэ	H E G D EH ZH EH <SPACE>
хэды	H E D Y <SPACE>
хэдышье	H E D Y SH J EH <SPACE>
хэдэг	H E D EH K <SPACE>
хэдэн	H E D EH NG <SPACE>
хэжэ	H E ZH EH <SPACE>
хэжэл	H E ZH EH L <SPACE>
хэжэнгын	H E ZH EH NG G Y NG <SPACE>
хэзээ	H E Z EE <SPACE>
хэзээб	H E Z EE P <SPACE>
хэлсэдэг	H E L S EH D EH K <SPACE>
хэлсээ	H E L S EE <SPACE>
хэлсээн	H E L S EE NG <SPACE>
хэлсүүлхэгүйн	H E L S UUs L H EH Gr UIs NG <SPACE>
хэлые	H EH L Y J EH <SPACE>
хэлыень	H EH L Y J EH NJ <SPACE>
хэлэ	H E L EH <SPACE>
хэлэбэ	H EH L EH V EH <SPACE>
хэлэбэл	H E L EH V EH L <SPACE>
хэлэгдээ	H E L EH G D EE <SPACE>
хэлэдэг	H E L EH D EH K <SPACE>
хэлэеэ	H E L EE J EE <SPACE>
хэлэжэ	H E L EH ZH EH <SPACE>
хэлэжэрхидэг	H E L EH ZH E R HJ I D EH K <SPACE>
хэлэмнай	H E L EH M N EE <SPACE>
хэлэн	H E L EH NG <SPACE>
хэлэнгүй	H E L EH NG G UIs <SPACE>
хэлэндэ	H E L EH N D EH <SPACE>
хэлэндэнь	H EH L EH N D EH NJ <SPACE>
хэлэнэ	H E L EH N EH <SPACE>
хэлэнэй	H E L EH N EE <SPACE>
хэлэнэйнгээ	H EH L EH N EE NG G EE <SPACE>
хэлэнүүд	H E L EH N UUs T <SPACE>
хэлэтэй	H E L EH T EE <SPACE>
хэлэхэ	H EH L EH H EH <SPACE>
хэлэхэбши	H EH L EH H EH P SH Y <SPACE>
хэлэхэдэ	H EH L EH H EH D EH <SPACE>
хэлэхэеэ	H EH L EH H EH J EE <SPACE>
хэлэхээр	H E L EH H EE R <SPACE>
хэлээ	H E L EE <SPACE>
хэлээб	H EH L EE P <SPACE>
хэлээгүй	H E L EE Gr UIs <SPACE>
хэлээр	H E L EE R <SPACE>
хэлэһэн	H EH L EH HH EH NG <SPACE>
хэлэһэниинь	H E L EH HH EH NJ II NJ <SPACE>
хэмжээ	H E M ZH EE <SPACE>
хэмжээлгээрээ	H E M ZH EE L Gr EE R EE <SPACE>
хэмжээндэ	H E M ZH EE N D EH <SPACE>
хэмжээнэй	H E M ZH EE N EE <SPACE>
хэмжээтэйгээр	H E M ZH EE T EE Gr EE R <SPACE>
хэн	H E NG <SPACE>
хэнхэй	H E N H EE <SPACE>
хэншье	H E N SH J EH <SPACE>
хэнэбди	H E N EH B DJ I <SPACE>
хэнэй	H E N EE <SPACE>
хэр	H E R <SPACE>
хэрбэеэ	H E R V EH J EE <SPACE>
хэрбээ	H E R V EE <SPACE>
хэрэг	H E R EH K <SPACE>
хэрэггүй	H E R EH G G UIs <SPACE>
хэрэглэгдэхэеэ	H E R EH G L EH G D EH H EH J EE <SPACE>
хэрэглэжэ	H E R EH G L EH ZH EH <SPACE>
хэрэглэн	H E R EH G L EH NG <SPACE>
хэрэглэхэ	H E R EH G L EH H EH <SPACE>
хэрэглэһэн	H E R EH G L EH HH EH NG <SPACE>
хэрэгнай	H E R EH G N EE <SPACE>
хэрэгсэлээ	H E R EH G S EH L EE <SPACE>
хэрэгтэ	H E R EH K T EH <SPACE>
хэрэгтэй	H E R EH K T EE <SPACE>
хэрэгээ	H E R EH Gr EE <SPACE>
хэрэгүүд	H E R EH Gr UUs T <SPACE>
хэрэм	H E R EH M <SPACE>
хэрэнэй	H E R EH N EE <SPACE>
хэсуу	H EH S UUh <SPACE>
хэсүү	H E S UUs <SPACE>
хэтын	H E T Y NG <SPACE>
хэтэдэ	H E T EH D EH <SPACE>
хэхээр	H E H EE R <SPACE>
хэшээл	H E SH EE L <SPACE>
хэшээлынь	H E SH EE L Y NJ <SPACE>
хэшээлээ	H E SH EE L EE <SPACE>
хээлитэй	H EE LJ I T EE <SPACE>
хүбшэргэйе	H Us P SH EH R Gr EE J EH <SPACE>
хүбүүгээ	H Us V UUs Gr EE <SPACE>
хүбүүд	H Us V UUs T <SPACE>
хүбүүдтэй	H Us V UUs T T EE <SPACE>
хүбүүдые	H Us V UUs D Y J EH <SPACE>
хүбүүдэй	H Us V UUs D EE <SPACE>
хүбүүдээ	H Us V UUs D EE <SPACE>
хүбүүе	H Us V UUs J EH <SPACE>
хүбүүмнай	H Us V UUs M N EE <SPACE>
хүбүүн	H Us V UUs NG <SPACE>
хүбүүндэ	H Us V UUs N D EH <SPACE>
хүбүүндээ	H Us V UUs N D EE <SPACE>
хүбүүтэйб	H Us V UUs T EE P <SPACE>
хүбүүхэн	H Us V UUs H EH NG <SPACE>
хүбүүхэнэй	H Us V UUs H EH N EE <SPACE>
хүгжэлтые	H Us G ZH EH L T Y J EH <SPACE>
хүгжэлтын	H Us G ZH EH L T Y NG <SPACE>
хүгжэлтэ	H Us G ZH EH L T EH <SPACE>
хүгжэлтэдэ	H Us G ZH EH L T EH D EH <SPACE>
хүгжэм	H Us G ZH EH M <SPACE>
хүгжэмшэд	H Us G ZH EH M SH EH T <SPACE>
хүгжэмөөр	H Us G ZH EH M OOs R <SPACE>
хүгжэнги	H Us G ZH EH NG GJ I <SPACE>
хүгжэхэ	H Us G ZH EH H EH <SPACE>
хүгжэһэн	H Us G ZH EH HH EH NG <SPACE>
хүгжөө	H Us G ZH OOs <SPACE>
хүгжөөжэ	H Us G ZH OOs ZH EH <SPACE>
хүгжөөлхэдэ	H Us G ZH OOs L H EH D EH <SPACE>
хүгжөөнэ	H Us G ZH OOs N EH <SPACE>
хүгжөөнэгүй	H Us G ZH OOs N EH Gr UIs <SPACE>
хүгжөөхөөр	H Us G ZH OOs H OOs R <SPACE>
хүгшэд	H Us G SH EH T <SPACE>
хүгшэдые	H Us G SH EH D Y J EH <SPACE>
хүгшэн	H Us G SH EH NG <SPACE>
хүдэлгэн	H Us D EH L Gr EH NG <SPACE>
хүдэлгэһэнөө	H Us D EH L Gr EH HH EH N OOh <SPACE>
хүдэлгүүр	H Us D EH L Gr UUs R <SPACE>
хүдэлгүүртэй	H Us D EH L Gr UUs R T EE <SPACE>
хүдэлгөөжэ	H Us D EH L Gr OOs ZH EH <SPACE>
хүдэлдэг	H Us D EH L D EH K <SPACE>
хүдэлжэ	H Us D EH L ZH EH <SPACE>
хүдэлмэридэ	H Us D EH L M EH RJ I D EH <SPACE>
хүдэлмэрилжэ	H Us D EH L M EH RJ I L ZH EH <SPACE>
хүдэлмэримнай	H Us D EH L M EH RJ I M N EE <SPACE>
хүдэлмэришэ	H Us D EH L M EH RJ I SH EH <SPACE>
хүдэлхыень	H Us D EH L H Y J EH NJ <SPACE>
хүдэлхэ	H Us D EH L H EH <SPACE>
хүдэлхэгүй	H Us D EH L H EH Gr UIs <SPACE>
хүдэлхэдөө	H Us D EH L H EH D OOs <SPACE>
хүдэлхэеэ	H Us D EH L H EH J EE <SPACE>
хүдэлһэн	H Us D EH L HH EH NG <SPACE>
хүдэлөө	H Us D EH L OOs <SPACE>
хүдэлөөд	H Us D EH L OOs T <SPACE>
хүдөө	H Us D OOs <SPACE>
хүдөөгэй	H Us D OOs Gr EE <SPACE>
хүдөөгэймнай	H Us D OOs Gr EH M N EE <SPACE>
хүдөөһөө	H Us D OOs HH OOs <SPACE>
хүзүүбшэ	H Us Z UUs P SH EH <SPACE>
хүйтэн	H UIs T EH NG <SPACE>
хуйтэн	H UIs T EH NG <SPACE>
хүйһөөрөө	H UIs HH OOs R OOs <SPACE>
хүл	H Us L <SPACE>
хүлгэн	H Us L Gr EH NG <SPACE>
хүлгөөдэг	H Us L Gr OOs D EH G <SPACE>
хүлгөөндэ	H Us L Gr OOs N D EH <SPACE>
хүлгөөнһөө	H Us L Gr OOs N HH OOs <SPACE>
хүлеэжэ	H Us LJ EE ZH EH <SPACE>
хүлеэсэтэй	H Us LJ EE S EH T EE <SPACE>
хүлеэхэ	H Us LJ EE H EH <SPACE>
хүлөө	H Us L OOs <SPACE>
хүм	H Us M <SPACE>
хүмүүжүүлгын	H Us M UUs ZH UUs L Gr Y NG <SPACE>
хүмүүжүүлжэ	H Us M UUs ZH UUs L ZH EH <SPACE>
хүмүүжүүлнэ	H Us M UUs ZH UUs L N EH <SPACE>
хүн	H Us NG <SPACE>
хүнби	H Us NG BJ I <SPACE>
хүнгэн	H Us NG G EH NG <SPACE>
хүнгэхэнөөр	H Us NG G EH H EH N OOs R <SPACE>
хүндые	H Us N D Y J EH <SPACE>
хүндэ	H Us N D EH <SPACE>
хүндэлхэ	H Us N D EH L H EH <SPACE>
хүндэлэн	H Us N D EH L EH NG <SPACE>
хүндэлһэн	H Us N D EH L HH EH NG <SPACE>
хүндэмүүшэ	H Us N D EH M UUs SH EH <SPACE>
хүндэтэ	H Us N D EH T EH <SPACE>
хүндэтэй	H Us N D EH T EE <SPACE>
хүндөөр	H Us N D OOs R <SPACE>
хүниие	H Us NJ II J EH <SPACE>
хүнта	H Us N T EH <SPACE>
хүнэй	H Us N EE <SPACE>
хүнүүд	H Us N UUs T <SPACE>
хүнүүдтэ	H Us N UUs T T EH <SPACE>
хүнүүдтэй	H Us N UUs T T EE <SPACE>
хүнүүдэй	H Us N UUs D EE <SPACE>
хүнүүдээр	H Us N UUs D EE R <SPACE>
хүргэдэг	H Us R Gr EH D EH K <SPACE>
хүргэнэб	H Us R Gr EH N EH P <SPACE>
хүргэхэ	H Us R Gr EH H EH <SPACE>
хүрин	H Us RJ I NG <SPACE>
хүртэбэ	H Us R T EH V EH <SPACE>
хүртэнхэй	H Us R T EH N H EE <SPACE>
хүртэнэ	H Us R T EH N EH <SPACE>
хүртэһэн	H Us R T EH HH EH NG <SPACE>
хүрьгэниинь	H Us RJ Gr EH NJ II NJ <SPACE>
хүрьһэтэй	H Us RJ HH EH T EE <SPACE>
хүрэжэ	H Us R EH ZH EH <SPACE>
хүрэнэ	H Us R EH N EH <SPACE>
хүрэтэр	H Us R EH T EH R <SPACE>
хүрэтэрөө	H Us R EH T EH R OOs <SPACE>
хүрэхэдөө	H Us R EH H EH D OOs <SPACE>
хүрэһэн	H Us R EH HH EH NG <SPACE>
хүсэ	H Us S EH <SPACE>
хүсэжэ	H Us S EH ZH EH <SPACE>
хүсэлдэшэхэдэнь	H Us S EH L D EH SH EH H EH D EH NJ <SPACE>
хүсэлтэйб	H Us S EH L T EE P <SPACE>
хүсэлтэйбди	H Us S EH L T EE B DJ I <SPACE>
хүсэлөө	H O S EH L OOs <SPACE>
хүсэн	H Us S EH NG <SPACE>
хүсэндэ	H Us S EH N D EH <SPACE>
хүсэнтэй	H Us S EH N T EE <SPACE>
хүсэнэб	H Us S EH N EH P <SPACE>
хүсэнэй	H Us S EH N EE <SPACE>
хүсэтэй	H Us S EH T EE <SPACE>
хүсэхөөр	H Us S EH H OOs R <SPACE>
хүсэһэн	H Us S EH HH EH NG <SPACE>
хүсөөтэдэ	H Us S OOs T EH D EE <SPACE>
хүтэлбэри	H Us T EH L V EH RJ I <SPACE>
хүтэлбэрииин	H Us T EH L V EH RJ II NG <SPACE>
хүтэлбэрилхэдэ	H Us T EH L V EH RJ I L H EH D EH <SPACE>
хүтэлбэрилэгшэ	H Us T EH L V EH RJ I K SH EH <SPACE>
хүтэлбэрилэгшэт	H Us T EH L V EH RJ I K SH EH T <SPACE>
хүтэлбэрилэгшөөр	H Us T EH L V EH RJ I K SH OOs R <SPACE>
хүтэлбэритэй	H Us T EH L V EH RJ I T EE <SPACE>
хүтэрэлдөөд	H Us T EH R EH L D OOs T <SPACE>
хүхэ	H Us H EH <SPACE>
хүхюу	H Us HJ UUh <SPACE>
хүхюун	H Us HJ UUh NG <SPACE>
хүхюутэй	H Us HJ UUh T EE <SPACE>
хүхюутэйгөөр	H Us HJ UUh T EE Gr OOs R <SPACE>
хүшэрхэн	H Us SH EH R H EH NG <SPACE>
хүшөө	H Us SH OOs <SPACE>
хүүгэд	H UUs Gr EH T <SPACE>
хүүгэдни	H UUs Gr EH D NJ I <SPACE>
хүүгэдтэ	H UUs Gr EH T T EH <SPACE>
хүүгэдтэй	H UUs Gr EH T T EE <SPACE>
хүүгэдтээ	H UUs Gr EH T T EE <SPACE>
хүүгэдые	H UUs Gr EH D Y J EH <SPACE>
хүүгэдэй	H UUs Gr EH D EE <SPACE>
хүүндэ	H UUs N D EH <SPACE>
хүүнүүд	H UUs N UUs T <SPACE>
хүүртээ	H UUs R T EE <SPACE>
хөөрхэн	H OOs R H EH NG <SPACE>
хөөрэгдэнэ	H OOs R EH G D EH N EH <SPACE>
хөөрэдэг	H OOs R D EH D EH K <SPACE>
хөөрэжэ	H OOs R EH ZH EH <SPACE>
хөөрэлдэжэ	H OOs R EH L D EH ZH EH <SPACE>
хөөрэлдөөд	H OOs R EH L D OOs T <SPACE>
хөөрэлдөөн	H OOs R EH L D OOs NG <SPACE>
хөөрэлдөөндэ	H OOs R EH L D OOs N D EH <SPACE>
хөөрэнгүй	H OOs R EH NG G UIs <SPACE>
хөөрэнэ	H OOs R EH N EH <SPACE>
хөөрөөгөө	H OOs R OOs Gr OOs <SPACE>
хөөрөөнэй	H OOs R OOs N EE <SPACE>
хөөрөөнүүдыень	H OOs R OOs N UUs D Y J EH NJ <SPACE>
цыденов	C Y DJ E N O V <SPACE>
цыденова	C Y DJ E N O V A <SPACE>
цыдып	C Y D Y P <SPACE>
цыдыпова	C Y D Y P O V A <SPACE>
цындыма	C Y N D Y M A <SPACE>
цыпелма	C Y PJ E L M A <SPACE>
цыпелмаагай	C Y PJ E L M AA Gr EE <SPACE>
цыпелмаае	C Y PJ E L M AA J EH <SPACE>
цыпелмагай	C Y PJ E L M A Gr EE <SPACE>
цыпелмада	C Y PJ E L M A D EH <SPACE>
цыпелмае	C Y PJ E L M A J EH <SPACE>
цыренгармаев	C Y RJ E N G A R M A J E F <SPACE>
цыренгармаевые	C Y RJ E N G A R M A J E V Y J E <SPACE>
цыренгармын	C Y RJ E NG G A R M Y NG <SPACE>
цырендашиев	C Y RJ E N D A SH Y J E F <SPACE>
цырендоржиев	C Y RJ E N D O R ZH Y J E F <SPACE>
цырендоржиевна  C Y RJ E N D O R ZH Y J E V N A <SPACE>
цыренжапов	C Y RJ E N ZH A P O F <SPACE>
цыреноватай	C Y RJ E N O V A T EE <SPACE>
цыцык	C Y C Y K <SPACE>
чагатай	CH A Gr EH T EE <SPACE>
чемпион	CH E M PJ I O NG <SPACE>
чимитов	CH I MJ I T O F <SPACE>
чингис	CH I N GJ I S <SPACE>
чингисхаан	CH I N GJ I S H AA NG <SPACE>
чингисхаанай	CH I N GJ I S H AA N EE <SPACE>
чингисхана	CH I N GJ I S H EH N EH <SPACE>
шабинартань	SH A VJ I N EH R T EH NJ <SPACE>
шагнажа	SH A G N EH ZH EH <SPACE>
шагнаха	SH A G N EH H EH <SPACE>
шадаа	SH A D AA <SPACE>
шадабари	SH A D EH V EH RJ I <SPACE>
шадабарида	SH A D EH V EH RJ I D EH <SPACE>
шадабарииень	SH A D EH V EH RJ II J EH NJ <SPACE>
шадабаритай	SH A D EH V EH RJ I T EE <SPACE>
шадабаряараа	SH A D EH V EH RJ AA R AA <SPACE>
шададаг	SH A D EH D EH K <SPACE>
шадал	SH A D EH L <SPACE>
шадалаа	SH A D EH L AA <SPACE>
шадалтай	SH A D EH L T EE <SPACE>
шадалые	SH A D EH L Y J EH <SPACE>
шадана	SH A D EH N EH <SPACE>
шадар	SH A D EH R <SPACE>
шадараар	SH A D EH R AA R <SPACE>
шадаха	SH A D EH H EH <SPACE>
шажан	SH A ZH EH NG <SPACE>
шаланова	SH A L A N O V A <SPACE>
шалановае	SH A L A N O V A J EH <SPACE>
шалгалта	SH A L Gr EH L T EH <SPACE>
шалгаран	SH A L Gr EH R EH NG <SPACE>
шалгаруулха	SH A L Gr EH R UUh L H EH <SPACE>
шалгаха	SH A L Gr EH H EH <SPACE>
шалтаад	SH A L T AA T <SPACE>
шалтагһаа	SH A L T EH G HH AA <SPACE>
шамайе	SH A M EE J EH <SPACE>
шамда	SH A M D EH <SPACE>
шамтай	SH A M T EE <SPACE>
шанагаяа	SH A N EH Gr EH J AA <SPACE>
шанажа	SH A N EH ZH EH <SPACE>
шаналга	SH A N EH L Gr EH <SPACE>
шанар	SH A N EH R <SPACE>
шанартай	SH A N EH R T EE <SPACE>
шанартайе	SH A N EH R T EE J EH <SPACE>
шанга	SH A NG G EH <SPACE>
шангай	SH A NG G EE <SPACE>
шанда	SH A N D EH <SPACE>
шандаганай	SH A N D EH Gr EH N EE <SPACE>
шандаганда	SH A N D EH Gr EH N D EH <SPACE>
шараа	SH A R AA <SPACE>
шарайтай	SH A R EE T EE <SPACE>
шарайшье	SH A R EE SH J EH <SPACE>
шараһан	SH A R EH HH EH NG <SPACE>
шата	SH A T EH <SPACE>
шатаар	SH A T AA R <SPACE>
шаташаһан	SH A T EH SH EH HH EH NG <SPACE>
шатын	SH A T Y NG <SPACE>
шах	SH A H <SPACE>
шахуу	SH A H UUh <SPACE>
швециин	SH VJ E C Y NG <SPACE>
шеметова	SH E MJ E T O V A <SPACE>
шенхоров	SH E N H O R O F <SPACE>
шенхорова	SH E N H O R O V A <SPACE>
шенхоровагай	SH E N H O R O V A Gr EE <SPACE>
шенхоровтоной	SH E N H O R O F T EH N EE <SPACE>
ши	SH Y <SPACE>
шииг	SH Y K <SPACE>
шиидхэбэл	SH Y T H EH V EH L <SPACE>
шиидхэгдээгүй	SH Y T H EH G D EE Gr UIs <SPACE>
шиидхэхы	SH Y T H EH H Y <SPACE>
шиидхэхэ	SH Y T H EH H EH <SPACE>
шиидэһэн	SH Y D EH HH EH NG <SPACE>
шинии	SH Uh NJ II <SPACE>
шишкинские	SH Y SH KJ I N S KJ I J E <SPACE>
шкаф	SH K A F <SPACE>
шог	SH O K <SPACE>
шогтой	SH O K T EE <SPACE>
шонхо	SH O N H EH <SPACE>
шоо	SH OOh <SPACE>
шоройдожо	SH O R EE D EH ZH EH <SPACE>
шпагат	SH P A G A T <SPACE>
шри	SH RJ I <SPACE>
шубууд	SH Uh V UUh T <SPACE>
шубуун	SH Uh V UUh NG <SPACE>
шугам	SH Uh Gr EH M <SPACE>
шугамууд	SH Uh Gr EH M UUh T <SPACE>
шудалагдажал	SH Uh D EH L EH G D EH ZH EH L <SPACE>
шудалагдан	SH Uh D EH L EH G L EH NG <SPACE>
шудалалга	SH Uh D EH L EH L Gr EH <SPACE>
шудалалгада	SH Uh D EH L EH L Gr EH D EH <SPACE>
шудалалгын	SH Uh D EH L EH L Gr Y NG <SPACE>
шудалдаг	SH Uh D EH L D EH K <SPACE>
шудалжал	SH Uh D EH L ZH EH L <SPACE>
шудалха	SH Uh D EH L H EH <SPACE>
шудалхаар	SH Uh D EH L H AA R <SPACE>
шудалһан	SH Uh D EH L HH EH NG <SPACE>
шударгы	SH Uh D EH R Gr Y <SPACE>
шулуу	SH Uh L UUh <SPACE>
шулуун	SH Uh L UUh NG <SPACE>
шулуунууд	SH Uh L UUh N UUh T <SPACE>
шуналтай	SH Uh N EH L T EE <SPACE>
шунгалга	SH Uh NG EH L Gr EH <SPACE>
шуран	SH Uh R EH NG <SPACE>
шуугаа	SH UUh Gr AA <SPACE>
шуумайса	SH UUh M EE S EH <SPACE>
шуурган	SH UUh R Gr EH NG <SPACE>
шууяа	SH UUh J AA <SPACE>
шууялдаан	SH UUh J A L D AA NG <SPACE>
шухала	SH Uh H EH L EH <SPACE>
шэбхэдэдэггүйбди	SH E P H EH D EH D EH G G UIs B DJ I <SPACE>
шэбхэдэнэгүй	SH E P H EH D EH N EH Gr UIs <SPACE>
шэбшэбэ	SH E P SH EH V EH <SPACE>
шэбэртэ	SH E V EH R T EH <SPACE>
шэбэртэеэ	SH E V EH R T EH J EE <SPACE>
шэглэлтэй	SH E G L EH L T EE <SPACE>
шэди	SH E DJ I <SPACE>
шэдитэ	SH E DJ I T EH <SPACE>
шэлэгдээ	SH E L EH G D EE <SPACE>
шэлэдэг	SH E L EH D EH K <SPACE>
шэлэдэгдэхээр	SH E L EH D EH G D EH H EE R <SPACE>
шэлэжэ	SH E L EH ZH EH <SPACE>
шэлэн	SH E L EH NG <SPACE>
шэлэхэ	SH E L EH H EH <SPACE>
шэмэг	SH E M EH K <SPACE>
шэмэглэжэрхёо	SH E M EH G L EH ZH EH R HJ OOh <SPACE>
шэмээшэгүүд	SH E M EE SH EH Gr UUs T <SPACE>
шэнгеэр	SH E NG GJ EE R <SPACE>
шэнги	SH E NG GJ I <SPACE>
шэнгэжэ	SH E NG G EH ZH EH <SPACE>
шэнгэн	SH E NG G EH NG <SPACE>
шэнгэрүүһэд	SH E NG G EH R UUs HH EH T <SPACE>
шэнжэлбэб	SH E N ZH EH L V EH P <SPACE>
шэнжэлдэг	SH E N ZH EH L D EH K <SPACE>
шэнжэлхэеэ	SH E N ZH EH L H EH J EE <SPACE>
шэнжэлэгдээ	SH E N ZH EH L EH G D EE <SPACE>
шэнжэлэн	SH E N ZH EH L EH N <SPACE>
шэнжэнүүд	SH E N ZH EH N UUs T <SPACE>
шэнжэтэй	SH E N ZH EH T EE <SPACE>
шэнхинээн	SH E N HJ I N EE NG <SPACE>
шэнэ	SH E N EH <SPACE>
шэрдэг	SH E R D EH G <SPACE>
шэртэн	SH E R T EH NG <SPACE>
шэрэ	SH E R EH <SPACE>
шэтэ	SH E T EH <SPACE>
шэхэндэ	SH E H EH N D EH <SPACE>
шүдэнэй	SH Us D EH N EE <SPACE>
шүлыень	SH Us L Y J EH NJ <SPACE>
шүлэг	SH Us L EH K <SPACE>
шүлэгдэмэл	SH Us L EH G D EH M EH L <SPACE>
шүлэгшын	SH Us L EH K SH Y NG <SPACE>
шүлэгшэ	SH Us L EH K SH EH <SPACE>
шүлэгэй	SH Us L EH Gr EE <SPACE>
шүлэгүүд	SH Us L EH Gr UUs T <SPACE>
шүлэгүүдыень	SH Us L EH Gr UUs D Y J EH NJ <SPACE>
шүлэгүүдэй	SH Us L EH Gr UUs D EE <SPACE>
шүлэгүүдээ	SH Us L EH Gr UUs D EE <SPACE>
шүлэгүүдээр	SH Us L EH Gr UUs D EE R <SPACE>
шүлэгүүдээрээ	SH Us L EH Gr UUs D EE R EE <SPACE>
шүлэгөөрөө	SH Us L EH G OOs R OOs <SPACE>
шүлһэ	SH Us L HH EH <SPACE>
шүтэлгын	SH Us T EH L Gr Y NG <SPACE>
шүүжэ	SH UUh ZH EH <SPACE>
шүүлэгүүдэй	SH UUh L EH Gr UUs D EE <SPACE>
эбтэй	E P T EE <SPACE>
эвенкнүүдтэй	E VJ E N K N UUs T T EE <SPACE>
эгэшэ	E Gr EH SH EH <SPACE>
эгээ	E Gr EE <SPACE>
эгээл	E Gr EE L <SPACE>
эдеэ	E DJ EE <SPACE>
эдеэгээ	E DJ EE Gr EE <SPACE>
эдеэгээр	E DJ EE Gr EE R <SPACE>
эдеэлхэ	E DJ EE L H EH <SPACE>
эдеэлүүлхэдээ	E DJ EE L UUs L H EH D EE <SPACE>
эди	E DJ I <SPACE>
эдижэ	E DJ I ZH EH <SPACE>
эдир	E DJ I R <SPACE>
эдиршүүлдэ	E DJ I R SH UUs L D EH <SPACE>
эдлээ	E T L EE <SPACE>
эдэ	E D EH <SPACE>
эдэбхи	E D EH P HJ I <SPACE>
эдэбхитэй	E D EH P HJ I T EE <SPACE>
эдэбхитэйгээр	E D EH P HJ I T EE Gr EE R <SPACE>
эетэй	E J EH T EE <SPACE>
эжы	E ZH Y <SPACE>
эжыдээ	E ZH Y D EE <SPACE>
эжые	E ZH Y J EH <SPACE>
эжымни	E ZH Y M NJ I <SPACE>
эжын	E ZH Y NG <SPACE>
эжынь	E ZH Y NJ <SPACE>
эжэл	E ZH EH L <SPACE>
эжэлүүдгүй	E ZH EH L UUs D G UIs <SPACE>
эзэлхын	E Z EH L H Y NG <SPACE>
эзэмдэжэ	E Z EH M D EH ZH EH <SPACE>
эзэмдэн	E Z EH M D EH NG <SPACE>
эзэн	E Z EH NG <SPACE>
экспедицеэр	E K S PJ E DJ I C EE R <SPACE>
экспедицимнай	E K S PJ E DJ I C EH M N EE <SPACE>
экшн	E K SH NG <SPACE>
элбэг	E L V EH K <SPACE>
элдэб	E L D EH P <SPACE>
элдэдэг	E L D EH D EH K <SPACE>
электронно	E LJ E K T R O N EH <SPACE>
элидхэлнүүд	E LJ I T H EH L N UUs T <SPACE>
элинсэг	E LJ I N S EH K <SPACE>
элинсэгэй	E LJ I N S EH Gr EE <SPACE>
элирүүлэгдээ	E LJ I R UUs L EH G D EE <SPACE>
элитэ	E LJ I T EH <SPACE>
элсүүлэнхэй	E L S UUs L EH N H EE <SPACE>
элшэтэ	E L SH EH T EH <SPACE>
эльбээд	E LJ V EE T <SPACE>
эльгээгдэһээн	E LJ G EE G D EH HH EE NG <SPACE>
эльгээхые	E LJ G EE H Y J EH <SPACE>
элүүр	E L UUs R <SPACE>
элһэнби	E L HH EH NG BJ I <SPACE>
эм	E M <SPACE>
эмхи	E M HJ I <SPACE>
эмхидхэгдэжэ	E M HJ I T H EH G D EH ZH EH <SPACE>
эмхидхэгдэһэн	E M HJ I T H EH G D EH HH EH NG <SPACE>
эмхидхэдэг	E M HJ I T H EH D EH K <SPACE>
эмхидхэхээр	E M HJ I T H EH H EE R <SPACE>
эмхидхээ	E M HJ I T H EE <SPACE>
эмхидхэһэн	E M HJ I T H EH HH EH NG <SPACE>
эмхинүүд	E M HJ I N UUs T <SPACE>
эндэ	E N D EH <SPACE>
эндэһээ	E N D EH HH EE <SPACE>
энеэбхилэн	E NJ EE P HJ I L EH NG <SPACE>
энеэдэн	E NJ EE D EH NG <SPACE>
энеэлдэн	E NJ EE L D EH NG <SPACE>
энеэнэ	E NJ EE N EH <SPACE>
энхэ	E N H EH <SPACE>
энэ	E N EH <SPACE>
энэдхэг	E N EH T H EH K <SPACE>
энэдхэгтэ	E N EH T H EH K T EH <SPACE>
энэдхэгэй	E N EH T H EH Gr EE <SPACE>
энэл	E N EH L <SPACE>
энэнь	E N EH NJ <SPACE>
энэшни	E N EH SH NJ I <SPACE>
энээн	E N EE NG <SPACE>
энээндэнь	E N EE N D EH NJ <SPACE>
энээниие	E N EE NJ II J EH <SPACE>
энээхэн	E N EE H EH NG <SPACE>
энээхэндэ	E N EE H EH N D EH <SPACE>
энээхэниие	E N EE H EH NJ II J EH <SPACE>
энэһээ	E N EH HH EE <SPACE>
эрдэм	E R D EH M <SPACE>
эрдэмтэд	E R D EH M T EH T <SPACE>
эрдэмтэдэй	E R D EH M T EH D EE <SPACE>
эрдэмтэн	E R D EH M T EH NG <SPACE>
эрдэмтэниие	E R D EH M T EH NJ II J EH <SPACE>
эрилтын	E RJ I L T Y NG <SPACE>
эрилтэ	E RJ I L T EH <SPACE>
эрмэлзэжэ	E R M EH L Z EH ZH EH <SPACE>
эртэ	E R T EH <SPACE>
эрхилжэ	E R HJ I L ZH EH <SPACE>
эрхилхэдэл	E R HJ I L H EH D EH L <SPACE>
эрхилэгшэд	E R HJ I L EH K SH EH T <SPACE>
эрхилэгшэдһээшье	E R HJ I L EH K SH EH T HH EE SH J EH <SPACE>
эрхые	E R H Y J EH <SPACE>
эрхэ	E R H EH <SPACE>
эрхүү	E R H UUs <SPACE>
эрхүүгэй	E R H UUs Gr EE <SPACE>
эрхүүгэйхид	E R H UUs Gr EE HJ I T <SPACE>
эршэ	E R SH EH <SPACE>
эршэмтэй	E R SH EH M T EE <SPACE>
эршэтэйгээр	E R SH EH T EE Gr EE R <SPACE>
эрье	E RJ J EH <SPACE>
эрьедэ	E RJ J EH D EH <SPACE>
эрьелдэнэ	E RJ J EH L D EH <SPACE>
эрьеэр	E RJ J EE R <SPACE>
эрэ	E R EH <SPACE>
эрэшүүлэй	E R EH SH UUs L EE <SPACE>
эрэһэн	E R EH HH EH NG <SPACE>
эсэбэритэй	E S EH V EH RJ I T EE <SPACE>
эсэгыемни	E S EH Gr Y J EH M NJ I <SPACE>
эсэгынгээ	E S EH Gr Y NG G EE <SPACE>
эсэгынгээл	E S EH Gr Y NG G EE L <SPACE>
эсэгэ	E S EH Gr EH <SPACE>
эсэгэдэнь	E S EH Gr EH D EH NJ <SPACE>
эсэгэдээ	E S EH Gr EH D EE <SPACE>
эсэгэеэ	E S EH Gr EH J EE <SPACE>
эсэгэмни	E S EH Gr EH M NJ I <SPACE>
эсэгэнь	E S EH Gr EH NJ <SPACE>
эсэгэнэрэйнгээ	E S EH Gr EH N EH R EE NG G EE <SPACE>
этигэл	E TJ I Gr EH L <SPACE>
этигэнэгүй	E TJ I Gr EH N EH Gr UIs <SPACE>
этнографическа	E T N EH G R A FJ I CH EH S K EH <SPACE>
эхилбэ	E HJ I L V EH <SPACE>
эхилжэ	E HJ I L ZH EH <SPACE>
эхилхэ	E HJ I L H EH <SPACE>
эхилхэдэнь	E HJ I L H EH D EH NJ <SPACE>
эхилхэдээ	E HJ I L H EH D EE <SPACE>
эхилхэдээл	E HJ I L H EH N D EE L <SPACE>
эхилээ	E HJ I L EE <SPACE>
эхилээб	E HJ I L EE P <SPACE>
эхилээд	E HJ I L EE T <SPACE>
эхилһэн	E HJ I L HH EH NG <SPACE>
эхин	E HJ I NG <SPACE>
эхиндэ	E HJ I N D EH <SPACE>
эхирэдбулагадай	E HJ I R EH D B Uh L EH Gr EH D EE <SPACE>
эхитэй	E HJ I T EE <SPACE>
эхынгээ	E H Y NG G EE <SPACE>
эхэ	E H EH <SPACE>
эхэнэр	E H EH N EH R <SPACE>
эшхэбтэр	E SH H EH P T EH R <SPACE>
эшэнгүй	E SH EH NG G UIs <SPACE>
эшэхэ	E SH EH H EH <SPACE>
ээрсэгээр	EE R S EH Gr EE R <SPACE>
ээрэжэ	EE R EH ZH EH <SPACE>
юм	J Uh M <SPACE>
юмбибди	J Uh M BJ I B DJ I <SPACE>
юрэ	J Uh R EH <SPACE>
юрэдөөл	J Uh R EH D OOs L <SPACE>
юрэнхылэгшэ	J Uh R EH N H Y L EH K SH EH <SPACE>
юрөө	J Uh R OOs <SPACE>
юу	J UUh <SPACE>
юуб	J UUh P <SPACE>
юугээр	J UUh Gr EE R <SPACE>
юугээрээ	J UUh Gr EE R EE <SPACE>
юум	J UUh M <SPACE>
юумыешни	J UUh M Y J EH SH NJ I <SPACE>
юумэ	J UUh M EH <SPACE>
юумэеэ	J UUh M EH J EE <SPACE>
юумэн	J UUh M EH NG <SPACE>
юумэндэ	J UUh M EH N D EH <SPACE>
юумэнэйнь	J UUh M EH N EE NJ <SPACE>
юумэнүүдые	J UUh M EH N UUs D Y J EH <SPACE>
юун	J UUh NG <SPACE>
юундэ	J UUh N D EH <SPACE>
юундэб	J UUh N D EH P <SPACE>
юуншье	J UUh N SH J EH <SPACE>
юунһээшье	J UUh N HH EE SH J EH <SPACE>
юһэдэхи	J Uh HH EH D EH HJ I <SPACE>
юһэн	J Uh HH EH NG <SPACE>
яажа	J AA ZH EH <SPACE>
яарадаггүйб	J AA R EH D EH G G UIs P <SPACE>
яаралгүй	J AA R EH L Gr UIs <SPACE>
яаралгүйхэн	J AA R EH L Gr UIs H EH NG <SPACE>
яахабши	J AA H EH P SH Y <SPACE>
ябаа	J A V AA <SPACE>
ябаарай	J A V AA R EE <SPACE>
ябаба	J A V EH V EH <SPACE>
ябадал	J A V EH D EH L <SPACE>
ябажа	J A V EH ZH EH <SPACE>
ябалган	J A V EH L Gr EH NG <SPACE>
ябалсааб	J A V EH L S AA P <SPACE>
ябана	J A V EH N EH <SPACE>
ябаха	J A V EH H EH <SPACE>
ябахада	J A V EH H EH D EH <SPACE>
ябахадаа	J A V EH H EH D AA <SPACE>
ябахадаал	J A V EH H EH D AA L <SPACE>
ябахадань	J A V EH H EH D EH NJ <SPACE>
ябахаяа	J A V EH H EH J AA <SPACE>
ябахыень	J A V EH H Y J EH NJ <SPACE>
ябахын	J A V EH H Y NG <SPACE>
ябаһаар	J A V EH HH AA R <SPACE>
ябаһан	J A V EH HH EH NG <SPACE>
ябуулаад	J A V UUh L AA T <SPACE>
ябуулагдаа	J A V UUh L EH G D AA <SPACE>
ябуулагшад	J A V UUh L EH G SH EH T <SPACE>
ябуулгаад	J A V UUh L Gr AA T <SPACE>
ябуулжа	J A V UUh L ZH EH <SPACE>
ябуулна	J A V UUh L N EH <SPACE>
ядалдаагүй	J A D EH L D AA Gr UIs <SPACE>
ядалсадаг	J A D EH L S EH D EH K <SPACE>
ядаха	J A D EH H EH <SPACE>
ядахагүйб	J A D EH H EH Gr UIs P <SPACE>
якутск	J A K Uh T S K <SPACE>
ялараа	J A L EH R AA <SPACE>
ялас	J A L EH S <SPACE>
ямар	J A M EH R <SPACE>
ямараар	J A M EH R AA R <SPACE>
ямаршье	J A M EH R SH J EH <SPACE>
январь	J A N V A RJ <SPACE>
янзын	J A N Z Y NG <SPACE>
янхаевтан	J A N H A J EH V T EH NG <SPACE>
япон	J A P O NG <SPACE>
яхадай	J A H EH D EE <SPACE>
яһала	J A HH EH L EH <SPACE>
яһанай	J A HH EH N EE <SPACE>
яһатан	J A HH EH T EH NG <SPACE>
яһатанай	J A HH EH T EH N EE <SPACE>
ёг	J O K <SPACE>
ёохор	J OOh H EH R <SPACE>
ёһо	J O HH EH <SPACE>
ёһоор	J O HH OOh R <SPACE>
ёһоороо	J O HH OOh R OOh <SPACE>
ёһотой	J O HH EH T EE <SPACE>
ёһотойл	J O HH EH T EE L <SPACE>
үбгэ	Us V Gr EH <SPACE>
үбгэд	Us V Gr EH T <SPACE>
үбшые	Us P SH Y J EH <SPACE>
үглөөгүүр	Us G L OOs Gr UUs R <SPACE>
үгтэдэг	Us K T EH D EH K <SPACE>
үгтэнэ	Us K T EH N EH <SPACE>
үгтэһэн	Us K T EH HH EH NG <SPACE>
үгы	Us Gr Y <SPACE>
үгыбши	Us Gr Y P SH Y <SPACE>
үгыдэ	Us Gr Y D EH <SPACE>
үгые	Us Gr Y J EH <SPACE>
үгылнэ	Us Gr Y L N EH <SPACE>
үгыт	Us Gr Y T <SPACE>
үгэ	Us Gr EH <SPACE>
үгэбэ	Us Gr EH V EH <SPACE>
үгэгдэһэн	Us Gr EH G D EH HH EH NG <SPACE>
үгэдэ	Us Gr EH D EH <SPACE>
үгэдэг	Us Gr EH D EH K <SPACE>
үгэнэ	Us Gr EH N EH <SPACE>
үгэнүүд	Us Gr EH N UUs T <SPACE>
үгэшье	Us Gr EH SH J EH <SPACE>
үгэһэн	Us Gr EH HH EH NG <SPACE>
үгөө	Us Gr OOs <SPACE>
үгөөб	Us Gr OOs P <SPACE>
үгөөрөө	Us Gr OOs R OOs <SPACE>
үдын	Us D Y NG <SPACE>
үдэ	Us D EH <SPACE>
үдэр	Us D EH R <SPACE>
үдэрнүүд	Us D EH R N UUs T <SPACE>
үдэрнүүдтэ	Us D EH R N UUs T T EH <SPACE>
үдэрнүүдые	Us D EH R N UUs D Y J EH <SPACE>
үдэшын	Us D EH SH Y NG <SPACE>
үдэшэ	Us D EH SH EH <SPACE>
үдэшэндөө	Us D EH SH EH N D OOs <SPACE>
үе	Us J EH <SPACE>
үедэ	Us J EH D EH <SPACE>
үедэнь	Us J EH D EH NJ <SPACE>
үедөө	Us J EH D OOs <SPACE>
үерлэн	Us J EH R L EH NG <SPACE>
үетэнөө	Us J EH T EH N OOs <SPACE>
үеын	Us J E Y NG <SPACE>
үеһөө	Us J EH HH OOs <SPACE>
үзэгдэдэг	Us Z EH G D EH D EH K <SPACE>
үзэгдэнэ	Us Z EH G D EH N EH <SPACE>
үзэдэггүйб	Us Z EH D EH G G UIs P <SPACE>
үзэдэгынь	Us Z EH D EH Gr Y NJ <SPACE>
үзэе	Us Z EH J EH <SPACE>
үзэжэ	Us Z EH ZH EH <SPACE>
үзэлгэ	Us Z EH L Gr EH <SPACE>
үзэлшэн	Us Z EH L SH EH NG <SPACE>
үзэсхэлэн	Us Z EH S H EH L EH NG <SPACE>
үзэсхэлэнтэ	Us Z EH S H EH L EH N T EH <SPACE>
үзэхэ	Us Z EH H EH <SPACE>
үзэхэгүй	Us Z EH H EH Gr UIs <SPACE>
үзэхэдэ	Us Z EH H EH D EH <SPACE>
үзэһэн	Us Z EH HH EH NG <SPACE>
үзүүлдэг	Us Z UUs L D EH K <SPACE>
үзүүлжэ	Us Z UUs L ZH EH <SPACE>
үзүүлхэ	Us Z UUs L H EH <SPACE>
үзүүлэгдэхэ	Us Z UUs L EH G D EH H EH <SPACE>
үзүүлһэн	Us Z UUs L HH EH NG <SPACE>
үзөөгүй	Us Z OOs Gr UIs <SPACE>
үй	UIs <SPACE>
үйлын	UIs L Y NG <SPACE>
үйлэ	UIs L EH <SPACE>
үйлэдбэрилхэ	UIs L EH D B EH RJ I L H EH <SPACE>
үйлэдбэрилһэн	UIs L EH D B EH RJ I L HH EH NG <SPACE>
үйлэдэхэ	UIs L EH D EH H EH <SPACE>
үлгы	Us L Gr Y <SPACE>
үлгөөтэй	Us L Gr OOs T EE <SPACE>
үлир	Us LJ I R <SPACE>
үлэн	Us L EH NG <SPACE>
үлэнхэй	Us L EH N H EE <SPACE>
үлэшоо	Us L EH SH OOh <SPACE>
үлэшэнэ	Us L EH SH EH N EH <SPACE>
үлэшэһэн	Us L EH SH EH HH EH NG <SPACE>
үлүү	Us L UUs <SPACE>
үлөөд	Us L OOs T <SPACE>
үлөөһэн	Us L OOs HH EH NG <SPACE>
үмсын	Us M S Y NG <SPACE>
үмөөрөөд	Us M OOs R OOs T <SPACE>
үнгэргэгдэһэн	Us NG G EH R Gr EH G D EH HH EH NG <SPACE>
үнгэргэгдөө	Us NG G EH R Gr EH G D OOs <SPACE>
үнгэргэхэ	Us NG G EH R H EH D EH <SPACE>
үнгэргөө	Us NG G EH R Gr OOs <SPACE>
үнгэрдэг	Us NG G EH R D EH K <SPACE>
үнгэрхэдөө	Us NG G EH R H EH D OOs <SPACE>
үнгэрэгшэ	Us NG G EH R EH G SH EH <SPACE>
үнгэрэмсөөр	Us NG G EH R EH M S OOs R <SPACE>
үнгэрһэн	Us NG G EH R EH HH EH NG <SPACE>
үнгэрөө	Us NG G EH R OOs <SPACE>
үнгэрөөб	Us NG G EH R OOs P <SPACE>
үнгэтэ	Us NG G EH T EH <SPACE>
үнгэтэй	Us NG G EH T EE <SPACE>
үндын	Us N D Y NG <SPACE>
үндыһэн	Us N D Y HH EH NG <SPACE>
үндэр	Us N D EH R <SPACE>
үндэһэд	Us N D EH HH EH T <SPACE>
үндэһэн	Us N D EH HH EH NG <SPACE>
үндэһэнһөө	Us N D EH HH EH N HH OOs <SPACE>
үндэһэтэ	Us N D EH HH EH T EH <SPACE>
үнеэ	Us NJ EE <SPACE>
үнжэгэн	Us N ZH EH Gr EH NG <SPACE>
үни	Us NJ I <SPACE>
үншэршэнхэй	Us N SH EH R SH EH N H EE <SPACE>
үнэн	Us N EH NG <SPACE>
үнэндөө	Us N EH N D OOs <SPACE>
үнэр	Us N EH R <SPACE>
үнэтэ	Us N EH T EH <SPACE>
үнэтэй	Us N EH T EE <SPACE>
үнэхөөрөө	Us N EH H OOs R OOs <SPACE>
үнэхөөрөөл	Us N EH H OOs R OOs L <SPACE>
үнөөхи	Us N OOs HJ I <SPACE>
үргэе	Us R Gr EH J EH <SPACE>
үргэлжэ	Us R Gr EH L ZH EH <SPACE>
үргэлжэлүүлэгдээ	Us R Gr EH L ZH E L UUs L EH G D EE <SPACE>
үргэн	Us R Gr EH NG <SPACE>
үргэнэ	Us R Gr EH N EH <SPACE>
үргэнөөр	Us R Gr EH N OOs R <SPACE>
үргөө	Us R Gr OOs <SPACE>
үргөөш	Us R Gr OOs SH <SPACE>
үрдеэгүй	Us R DJ EE Gr UIs <SPACE>
үреэ	Us RJ EE <SPACE>
үри	Us RJ I <SPACE>
үринь	Us RJ I NJ <SPACE>
үрхэ	Us R H EH <SPACE>
үрэжэлтэй	Us R EH ZH EH L T EE <SPACE>
үсхэлдэрэйхи	Us S H EH L D EH R EE HJ I <SPACE>
үсэгэлдэр	Us S EH Gr EH L D EH R <SPACE>
үсэгэлдэртөө	Us S EH Gr EH L D EH R T OOs <SPACE>
үсөөн	Us S OOs NG <SPACE>
үсөөрөө	Us S OOs R OOs <SPACE>
үтэрхэн	Us T EH R H EH NG <SPACE>
үхибүүд	Us HJ I V UUs T <SPACE>
үхибүүднай	Us HJ I V UUs D N EE <SPACE>
үхибүүдтэ	Us HJ I V UUs T T EH <SPACE>
үхибүүдые	Us HJ I V UUs D Y J EH <SPACE>
үхибүүдэй	Us HJ I V UUs D EE <SPACE>
үхибүүдэйнгээ	Us HJ I V UUs D EE NG G EE <SPACE>
үхибүүн	Us HJ I V UUs NG <SPACE>
үхибүүндээ	Us HJ I V UUs N D EE <SPACE>
үхибүүниинь	Us HJ I V UUs NJ II NJ <SPACE>
үхибүүтэй	Us HJ I V UUs T EE <SPACE>
үхэр	Us H EH R <SPACE>
үхэрнүүд	Us H EH R N UUs T <SPACE>
үхэртэй	Us H EH R T EE <SPACE>
үхэхэш	Us H EH H EH SH <SPACE>
үшөө	Us SH OOs <SPACE>
үшөөл	Us SH OOs L <SPACE>
үшөөшье	Us SH OOs SH J EH <SPACE>
үүдэ	UUs D EH <SPACE>
үүдэн	UUs D EH NG <SPACE>
үүдэнэй	UUs D EH N EE <SPACE>
үүдэшэн	UUs D EH SH EH NG <SPACE>
үүдэшэнөөр	UUs D EH SH EH N OOs R <SPACE>
үүдээ	UUs D EE <SPACE>
үүргэ	UUs R Gr EH <SPACE>
үүргэтэй	UUs R Gr EH T EE <SPACE>
үүсхэл	UUs S H EH L <SPACE>
һаа	HH AA <SPACE>
һаалган	HH AA L Gr EH NG <SPACE>
һаам	HH AA M <SPACE>
һаамнай	HH AA M N EE <SPACE>
һаамни	HH AA M NJ I <SPACE>
һаань	HH AA NJ <SPACE>
һаданар	HH A D EH N EH R <SPACE>
һадаһад	HH A D EH HH EH T <SPACE>
һадаһадай	HH A D EH HH EH D EE <SPACE>
һадаһаднай	HH A D EH HH EH D N EE <SPACE>
һажаажа	HH A ZH AA ZH EH <SPACE>
һажаанхай	HH A ZH AA N H EE <SPACE>
һайжаруулхаар	HH EE ZH EH R UUh L H AA R <SPACE>
һайн	HH EE NG <SPACE>
һайнаар	HH EE N AA R <SPACE>
һайнааршье	HH EE N AA R SH J EH <SPACE>
һайндэр	HH EE N D EH R <SPACE>
һайндэрнүүдые	HH EE N D EH R N UUs D Y J EH <SPACE>
һайндэртэ	HH EE N D EH R T EH <SPACE>
һайнууд	HH EE N UUh T <SPACE>
һайса	HH EE S EH <SPACE>
һайхан	HH EE H EH NG <SPACE>
һайханаар	HH EE H EH N AA R <SPACE>
һайханай	HH EE H EH N EE <SPACE>
һайханиие	HH EE H EH NJ II J EH <SPACE>
һайханиинь	HH EE H EH NJ II NJ <SPACE>
һайхашаагдаа	HH EE H EH SH AA G D AA <SPACE>
һайшаалтай	HH EE SH AA L T EE <SPACE>
һалбаран	HH A L V EH R EH NG <SPACE>
һалбарида	HH A L V EH RJ I D EH <SPACE>
һалхин	HH A L HJ I NG <SPACE>
һалхинай	HH A L HJ I N EE <SPACE>
һамбаашалан	HH A M B AA SH EH L EH NG <SPACE>
һанаа	HH A N AA <SPACE>
һанааб	HH A N AA P <SPACE>
һанаагаа	HH A N AA Gr AA <SPACE>
һанаагаараа	HH A N AA Gr AA R AA <SPACE>
һанаархалга	HH A N AA R H EH L Gr EH <SPACE>
һанаатай	HH A N AA T EE <SPACE>
һанаатайб	HH A N AA T EE P <SPACE>
һанаатайбди	HH A N AA T EE B DJ I <SPACE>
һанааһаань	HH A N AA HH AA NJ <SPACE>
һанагдаа	HH A N EH G D AA <SPACE>
һанагдана	HH A N EH G D EH N EH <SPACE>
һанагшаб	HH A N EH G SH EH P <SPACE>
һанадаг	HH A N D EH K <SPACE>
һанадаггүйб	HH A N EH D EH G Gr UIs P <SPACE>
һанажа	HH A N EH ZH EH <SPACE>
һанал	HH A N EH L <SPACE>
һанамжа	HH A N EH M ZH EH <SPACE>
һанамжануудые	HH A N EH M ZH EH N UUh D Y J EH <SPACE>
һананаб	HH A N EH N EH P <SPACE>
һананагүйб	HH A N EH N EH G UIs P <SPACE>
һананам	HH A N EH N EH M <SPACE>
һанахаар	HH A N EH H AA R <SPACE>
һанахада	HH A N EH H EH D EH <SPACE>
һанашадагби	HH A N EH SH EH D EH G BJ I <SPACE>
һанаһан	HH A N EH HH EH NG <SPACE>
һандарааб	HH A N D EH R AA P <SPACE>
һандараагүй	HH A N D EH R AA Gr UIs <SPACE>
һандарал	HH A N D EH R EH L <SPACE>
һандаралай	HH A N D EH R EH L EE <SPACE>
һандаранхай	HH A N D EH R EH N H EE <SPACE>
һандаргагдажа	HH A N D EH R Gr EH G D EH ZH EH <SPACE>
һандаргажа	HH A N D EH R Gr EH ZH EH <SPACE>
һандархада	HH A N D EH R H EH D EH <SPACE>
һарада	HH A R EH D EH <SPACE>
һарбайнаб	HH A R V EE N EH P <SPACE>
һаруулхан	HH A R UUh L H EH NG <SPACE>
һархяаг	HH A R HJ AA K <SPACE>
һарын	HH A R Y NG <SPACE>
һаяхан	HH A J EH H EH NG <SPACE>
һаяхана	HH A J EH H EH N EH <SPACE>
һмм	HH M <SPACE>
һогтуу	HH O K T UUh <SPACE>
һолонго	HH O L EH NG G EH <SPACE>
һонин	HH O NJ I NG <SPACE>
һонирхобобди	HH O NJ I R H EH V EH B DJ I <SPACE>
һонирходог	HH O NJ I R H EH D EH K <SPACE>
һонирхол	HH O NJ I R H EH L <SPACE>
һонирхолой	H O NJ I R H EH L EE <SPACE>
һонирхолтой	H O NJ I R H EH L T EE <SPACE>
һонирхолтойгоор	HH O NJ I R H EH L T EH R EE Gr OOh R <SPACE>
һонирхооб	HH O NJ I R H OOh P <SPACE>
һонирхоод	HH O NJ I R H OOh T <SPACE>
һонирхохо	HH O NJ I R H EH H EH <SPACE>
һонирхоһон	HH O NJ I R H EH HH EH NG <SPACE>
һонирхуулна	HH O NJ I R H UUh L N EH <SPACE>
һонирхуулха	HH O NJ I R H UUh L H EH <SPACE>
һонор	HH O N EH R <SPACE>
һорилго	HH O RJ I L Gr EH <SPACE>
һорилгодоо	HH O RJ I L Gr EH D OOh <SPACE>
һубиһандал	HH Uh VJ I HH EH N D EH L <SPACE>
һударһаа	HH Uh D EH R HH AA <SPACE>
һунгаа	HH Uh NG G AA <SPACE>
һунгажа	HH Uh NG G EH ZH EH <SPACE>
һураа	HH Uh R AA <SPACE>
һураад	HH Uh R AA T <SPACE>
һурагшад	HH Uh R EH K SH EH T <SPACE>
һурагшадтаа	HH Uh R EH K SH EH T T AA <SPACE>
һурадаг	HH Uh R EH D EH K <SPACE>
һуража	HH Uh R EH ZH EH <SPACE>
һуралсал	HH Uh R EH L S EH L <SPACE>
һуралсалай	HH Uh R EH L S EH L EE <SPACE>
һурана	HH Uh R EH N EH <SPACE>
һурахадаа	HH Uh R EH H EH D AA <SPACE>
һурахадатнай	HH Uh R EH H EH D EH T N EE <SPACE>
һурахаш	HH Uh R EH H EH SH <SPACE>
һурахаяа	HH Uh R EH H EH J AA <SPACE>
һурахын	HH Uh R EH H Y NG <SPACE>
һураһан	HH Uh R EH HH EH NG <SPACE>
һургаа	HH Uh R Gr AA <SPACE>
һургажа	HH Uh R Gr EH ZH EH <SPACE>
һургажархихань	HH Uh R Gr EH ZH EH R HJ I H EH NJ <SPACE>
һургал	HH Uh R Gr EH L <SPACE>
һурган	HH Uh R Gr EH NG <SPACE>
һургаха	HH Uh R Gr EH H EH <SPACE>
һургуули	HH Uh R Gr UUh LJ I <SPACE>
һургуулигүй	HH Uh R Gr UUh LJ I Gr UIs <SPACE>
һургуулида	HH Uh R Gr UUh LJ I D EH <SPACE>
һургуулиин	HH Uh R Gr UUh LJ II NG <SPACE>
һургуулиингаа	HH Uh R Gr UUh LJ II NG G AA <SPACE>
һургуулинууд	HH Uh R Gr UUh LJ I N UUh T <SPACE>
һургуулинуудай	HH Uh R Gr UUh LJ I N UUh D EE <SPACE>
һургуулинуудтай	HH Uh R Gr UUh LJ I N UUh T T EE <SPACE>
һургуулитай	HH Uh R Gr UUh LJ I T EE <SPACE>
һургуулияа	HH Uh R Gr UUh LJ I J AA <SPACE>
һуугаа	HH UUh Gr AA <SPACE>
һуури	HH UUh RJ I <SPACE>
һуурида	HH UUh RJ I D EH <SPACE>
һуурин	HH UUh RJ I NG <SPACE>
һуурингуудай	HH UUh RJ I NG UUh D EE <SPACE>
һууринуудые	HH UUh RJ I N UUh D Y J EH <SPACE>
һууринһаа	HH UUh RJ I N HH AA <SPACE>
һуухадам	HH UUh H EH D EH M <SPACE>
һуха	HH Uh H EH <SPACE>
һэдэлгэнь	HH E D EH L Gr EH NJ <SPACE>
һэжэрээ	HH E ZH EH R EE <SPACE>
һэлгэлдэн	HH E L Gr EH L D EH NG <SPACE>
һэм	HH E M <SPACE>
һэмби	HH E M BJ I <SPACE>
һэмди	HH E M DJ I <SPACE>
һэн	HH EH NG <SPACE>
һэргэлгын	HH E R Gr EH L G Y NG <SPACE>
һэргэлгэ	HH E R Gr EH L Gr EH <SPACE>
һэргээе	HH E R Gr EE J EH <SPACE>
һэргээжэ	HH E R Gr EE ZH EH <SPACE>
һэргээхын	HH E R Gr EE H Y NG <SPACE>
һэргээхэ	HH E R Gr EE H EH <SPACE>
һэргээхэбди	HH E R Gr EE H EH B DJ I <SPACE>
һэрюулээш	HH E RJ UUh L EE SH <SPACE>
һээ	HH EE <SPACE>
һү	HH Us <SPACE>
һүбэлгэн	HH Us V EH L Gr EH NG <SPACE>
һүзэгтэдтэй	HH Us Z EH K T EH T T EE <SPACE>
һүлдэ	HH Us L D EH <SPACE>
һүн	HH Us NG <SPACE>
һүни	HH Us NJ I <SPACE>
һүрөөтэй	HH Us R OOs T EE <SPACE>
һүүлдэ	HH UUs L D EH <SPACE>
һүүлдэнь	HH UUs L D EH NJ <SPACE>
һүүлшын	HH UUs L SH Y NG <SPACE>
һүүлэй	HH UUs L EE <SPACE>
һүүлээр	HH UUs L EE R <SPACE>
һүүлээрнь	HH UUs L EE R NJ <SPACE>
һүүн	HH UUs NG <SPACE>
һүүтэй	HH UUs T EE <SPACE>
һөөргэнь	HH OOs R EH NJ <SPACE>
һөөргөө	HH OOs R Gr OOs <SPACE>
өөрсэ	OOs R S EH <SPACE>
өөрын	OOs R Y NG <SPACE>
өөрынгөө	OOs R Y NG G OOs <SPACE>
өөрынхеэрээл	OOs R Y N HJ EE R EE L <SPACE>
өөрөө	OOs R OOs <SPACE>
өөрөөшье	OOs R OOs SH J EH <SPACE>
өөһэд	OOs HH EH T <SPACE>
өөһэдын	OOs HH EH D Y NG <SPACE>
өөһэдөө	OOs HH EH D OOs <SPACE>
өөһэнөө	OOs HH EH N OOs <SPACE>
шэмээгуй    SH E M EE Gr UIs <SPACE>
унгэроолда  Uh NG G EH R OOh L D A <SPACE>
эжынэрынь   E ZH Y N EH R Y NJ <SPACE>
багтаамжа   B A K T AA M ZH EH <SPACE>
амисгалан   A MJ I S H EH L EH NG <SPACE>
бужагануулһан   B Uh ZH EH Gr EH N UUh L HH EH NG <SPACE>
нэнгээд N E NG G EE T <SPACE>
хормойдо    H O R M EE D EH <SPACE>
адармаатайхан   A D EH R M AA T EE H EH NG <SPACE>
үбгөө   Us V G OOs <SPACE>
яларуулжа   J A L EH R UUh L ZH EH <SPACE>
худалдажа   H Uh D EH L D EH ZH EH <SPACE>
хуйтэндэ    H UIh T EH N D EH <SPACE>
эхэнэршэни  E H EH N EH R SH EH NG <SPACE>
эрьелдэнэ   E RJ J EH L D EH N EH <SPACE>
хадуурхагүйл    H A D UUh R H EH Gr UIs L <SPACE>
орьёлые O RJ J O L Y J EH <SPACE>
мүнхэлбэ    M Us N H E L V EH <SPACE>
уһаш    Uh HH EH SH <SPACE>
мүнхын  M Us NG H Y NG <SPACE>
аршаандаш   A R SH AA N D EH SH <SPACE>