ааб	AA P
аад	AA T
аалиншье	AA LJ I N SH J EH
аалихан	AA LJ I H EH NG
аба	A V EH
абаа	A V AA
абааб	A V AA P
абаабди	A V AA B DJ I
абаад	A V AA T
абаахайн	A V AA H EE NG
абаба	A V EH V EH
абабабди	A V EH V EH B DJ I
абагал	A V EH L
абадаг	A V EH D EH K
абадагби	A V EH D EH G BJ I
абажа	A V EH ZH EH
абалга	A V EH L Gr EH
абанги	A V EH N GJ I
абанхай	A V EH N H EE
абанхайб	A V EH N H EE P
абань	A V EH NJ
абаралга	A V EH R EH L Gr EH
абарга	A V EH R Gr EH
абари	A V EH RJ I
абарыт	A V EH R Y T
абатайм	A V EH T EH M
абашахаар	A V EH SH EH H AA R
абашни	A V EH SH NJ I I
абаһаа	A V EH HH AA
абаһан	A V EH HH EH NG
абаһандаа	A V EH HH EH N D AA
абгазы	A B G A Z Y
абгамни	A V Gr EH M NJ I
абгань	A V Gr EH NJ
абида	A VJ I D EH
абын	A V Y NG
абьяастай	A VJ J AA S T EE
августын	A F G Uh S T Y NG
автобус	A F T O V Uh S
автобусшье	A F T O V Uh S SH J EH
автор	A F T EH R
агаар	A Gr AA R
агаараар	A Gr AA R AA R
агаараарнь	A Gr AA R AA R NJ
агаарай	A Gr AA R EE
аглаг	A G L EH K
агууехэ	A Gr UUh J EH H EH
агын	A Gr Y NG
агынхидта	A Gr Y N HJ I D T EH
адабашьян	A D EH V EH SH J A NG
адаглааб	A D EH G L AA P
адли	A D LJ I
адлихан	A D LJ I H EH NG
адляар	A D LJ I R EH R
адууһа	A D UUh HH EH
ажа	A ZH EH
ажабайдал	A ZH EH B EE D EH L EH L
ажабайдалаар	A ZH EH B EE D EH L AA R
ажабайдалаймни	A ZH EH B EE D EH L N EE M NJ I
ажабайдалда	A ZH EH B EE D EH L D EH
ажабайдалдаа	A ZH EH B EE D EH L D EH
ажабайдалдань	A ZH EH B EE D EH L D EH NJ
ажал	A ZH EH L
ажалаа	A ZH EH L AA
ажалаар	A ZH EH L AA R
ажалай	A ZH EH L EE
ажалаймни	A ZH EH L EE M NJ I
ажалайнгаа	A ZH EH L EE N G AA
ажалгүйдэнэ	A ZH EH L Gr UIs D EH N EH
ажалда	A ZH EH L D EH
ажалдаа	A ZH EH L D AA
ажалдань	A ZH EH L D EH NJ
ажалжа	A ZH EH L ZH EH
ажаллаа	A ZH EH L AA
ажаллагшад	A ZH EH L L EH K SH EH T
ажаллажа	A ZH EH L L EH ZH EH
ажаллана	A ZH EH L L EH N EH
ажаллаха	A ZH EH L L EH H EH
ажалтай	A ZH EH L T EE
ажалтайт	A ZH EH L T EH T EE
ажалшад	A ZH EH L SH EH T
ажалыень	A ZH EH L Y J EH NJ
ажалһаа	A ZH EH L HH AA
ажалһаань	A ZH EH L HH AA NJ
ажахы	A ZH EH H Y
ажахын	A ZH EH H Y NG
ажахынуудые	A ZH EH H Y N UUh D Y J EH
ажаябуулгатай	A ZH EH J A V UUh L Gr EH T EE
ажаһуугаад	A ZH EH HH UUh Gr AA T
ажаһуугшад	A ZH EH HH UUh G SH EH T
ажаһуудаг	A ZH EH HH UUh D EH K
ажаһуудал	A ZH EH HH UUh D EH L
ажаһуудалда	A ZH EH HH UUh D EH L D EH
ажаһууна	A ZH EH HH UUh N EH
ажаһуунаб	A ZH EH HH UUh N EH P
ажаһууһан	A ZH EH HH UUh HH EH NG
азатай	A Z EH T EE
ази	A ZJ I
азиин	A ZJ I NG
айл	EE L
айлай	EE L EE
айлайхи	A L EE HJ I
айлнууд	EE L N UUh T
айлшаар	EE L SH AA R
айлшадаа	EE L SH EH D AA
айлшадай	EE L SH EH D EE
айлшалжа	EE L SH EH L ZH EH
айлшалхадаа	EE L SH EH L H EH D AA
айлшан	EE L SH EH NG
аймаг	EE M EH Gr EH
аймагаар	EE M EH Gr AA R
аймагай	EE M EH Gr EE
аймагта	EE M EH K T EH
аймагтаа	EE M EH K T AA
аймагтамнай	EE M EH K T EH M N EE
аймагуудай	EE M EH Gr UUh D EE
аймагуудта	EE M EH Gr UUh T T EH
аймшагтай	EE M SH EH K T EE
айн	EE NG
айхабтар	EE H EH B T EH R
академи	A K A DJ I M BJ I
академидэ	A K A DJ I M EH D EH
академик	A K A DJ E MJ I K
академическэ	A K A DJ E MJ I CH E S K EH
алаабхиһаа	A L AA P HJ I HH AA
алаабшанаар	A L AA P SH EH N AA R
алангуагай	A L EH N G Uh A Gr EE
аласдурна	A L EH S D Uh R N
албан	A L V EH NG
алгадажа	A L Gr EH D EH ZH EH
алдаа	A L D AA
алдарта	A L D EH R T EH
алдаха	A L D EH H EH
алдаһан	A L D EH HH EH NG
алдуу	A L D Uh
алдуугүй	A L D Uh Gr UIs
александр	A LJ E K S A N D R
алексей	A LJ E K SJ E J
али	A LJ I
алина	A LJ I N EH
алиханаар	A LJ I H EH N AA R
алишье	A LJ I SH J EH
алтаар	A L T AA R
алтай	A L T EE
алтан	A L T EH NG
алтанхан	A L T EH N H EH NG
алташаһаа	A L T EH SH EH HH AA
алташынадагай	A L T EH SH Y N UUs D EH Gr EE
алха	A L H EH
алхам	A L H EH M
альга	A LJ G EH
альгаа	A LJ G AA
аман	A M EH NG
амараад	A M EH R AA T
амаралтада	A M EH R EH L T EH D EH
амаралтадаа	A M EH R EH L T EH D AA
амаралтын	A M EH R EH L T Y NG
амардагби	A M EH R D EH G BJ I
амаржа	A M EH R ZH EH
амбаар	A M B AA R
амжалта	A M ZH EH L T EH
амжалтатайгаар	A M ZH EH L T EH T EE Gr AA R
амидардаг	A MJ I D EH R D EH K
амидарна	A MJ I D EH R N EH
амилжа	A MJ I L ZH EH
амилхада	A MJ I L H EH D EH
амисхаалаар	A MJ I S H AA L AA R
амитад	A MJ I T EH T
амитан	A MJ I T EH NG
амтархан	A M T EH R H EH NG
амтатай	A M T EH T EE
амударья	A M Uh D A RJ J EH
анастасия	A N EH S T EH SJ I J A
ангарск	A N G A R S K
андреевна	A N D RJ E J E V N A
андрей	A N D RJ E J
анна	A N EH
ансамблиин	A N S A M B LJ II NG
ансамбль	A N S A M B LJ
ансамбльтаяа	A N S A M B LJ T A
антоновна	A N T O N O V N A
анужд	A N Uh ZH T
анха	A N H EH
анхан	A N H EH NG
анхарал	A N H EH R EH L
анхаралаа	A N H EH R EH L AA
анхаралаашье	A N H EH R EH L AA SH J EH
апокалипсиса	A P O Gr A LJ I P SJ I S A
арад	A R EH T
арадай	A R EH D EE
арадайнгаа	A R EH D EE NG AA
арадтаа	A R EH D T AA
арадтаяа	A R EH D T EH J AA
арадуудай	A R EH D UUh D EE
арадуудые	A R EH D UUh D Y J EH
арба	A R V EH
арбагархан	A R V EH Gr EH R H EH NG
арбадахи	A R V EH D EH HJ I
арбан	A R V EH NG
арга	A R Gr EH
аргаар	A R Gr AA R
аргагүй	A R Gr EH Gr UIs
аргагүйгөөр	A R Gr EH Gr UIs Gr OOs R
аргагүйдэнэб	A R Gr EH Gr UIs D EH NJ
аргалжа	A R Gr EH L ZH EH
аргамгүй	A R Gr EH M G UIs
аргануудые	A R Gr EH N UUh D Y J EH
аргатай	A R Gr EH T EE
аргатайб	A R Gr EH T EE P
аргатайл	A R Gr EH T EE L
аргын	A R Gr Y NG
арендэ	A RJ E N D EH
арсалааб	A R S EH L AA P
арсалан	A R S EH L EH NG
арсалановтан	A R S EH L A F T EH NG
арсаһан	A R S EH HH EH NG
артист	A R TJ I S T
артистка	A R TJ I S T N A
артистнар	A R TJ I S T N EH R
артистнарай	A R TJ I S T N EH R EE
артистнартай	A R TJ I S T N EH R T EE
артистын	A R TJ I S T Y NG
архи	A R HJ I
архида	A R HJ I D EH
архитекторнүүд	A R HJ I TJ EH K T O HJ I T
архитектурна	A R HJ I TJ EH K T Uh R N K T Uh R N K T Uh
аршаан	A R SH AA NG
аршаанда	A R SH AA N D EH
аршажа	A R SH EH ZH EH
арюун	A RJ UUh NG
арюунтай	A RJ UUh N T EH T EE
арһа	A R HH EH
асараа	A S EH R AA
асараад	A S EH R AA T
асарагдаһан	A S EH R EH G D EH HH EH NG
асарба	A S EH R V EH
асарбат	A S EH R V EH T
асуудал	A S UUh D EH L
асуудалнууд	A S UUh D EH L N UUh T
асуудалнуудни	A S UUh D EH L N UUh D NJ I
асуудалнуудшье  A S UUh D EH L N UUh T SH J EH
асуудалые	A S UUh D EH L Y J EH
асууһааб	A S UUh HH AA P
асфальтаар  A S F A LJ T AA R
ася	A S J AA
атаархадаг	A T AA R H EH D EH K
афганай	A F G A N EE
афганистан	A F G A NJ I S T A N
афиша	A FJ I SH A
аха	A H EH
ахайе	A H EE J EH
аханарынь	A H EH N EH R Y NJ
ахань	A H EH NJ
аша	A SH EH
ашаар	A SH AA R
ашагдаһан	A SH EH G D EH HH AA NJ
ашада	A SH EH D EH
ашанар	A SH EH N EH R
ашанууднай	A SH EH N UUh D N EE
аюр	A J Uh R
аюрова	A J Uh R O V A
аюша	A J Uh SH A
аюшеевшье	A J Uh SH Uh J EH F SH J EH
аяар	A J AA R
аяга	A J A Gr A
аялга	A J A L Gr EH
аялгаар	A J A L Gr AA R
аялганууд	A J A L Gr EH N UUh T
аян	A J A NG
аяншалан	A J A SH N A L EH NG
аяншалга	A J EH N SH EH L Gr EH
аяншалгада	A J A SH N A G SH EH L Gr EH D EH
аяншалгашье	A J EH N SH J EH L Gr EH SH J EH
ба	B A
баабай	B AA V EE
баар	B AA R
баатай	B AA T EE
баатарнуудаараа	B AA T EH R N UUh D AA R AA
бабасановна	B A V EH S A N O V N A
бабур	B A V Uh R
бага	B A Gr EH
багаар	B A Gr AA R
багааршье	B A Gr AA R SH J EH
багадаа	B A Gr EH D AA
багадаашье	B A Gr EH D AA SH J EH
багадаев	B A Gr EH D A J EH F
багахан	B A Gr EH H EH NG
багаһаа	B A Gr EH HH AA
багсаагдана	B A G S AA G D EH N EH
багтаагүй	B A G T AA Gr UIs
багтаажа	B A G T AA ZH EH
багтаамжа	B A G T AA M ZH EH
багтаамжын	B A G T AA M ZH Y NG
багша	B A G SH EH
багшаар	B A K SH AA R
багшалнаб	B A G SH EH L N EH P
багшанар	B A K SH EH N EH R
багшанарай	B A K SH EH N EE R EE
багшанартай	B A K SH EH N EH R T EE
багшанарһаа	B A K SH EH N EH R HH AA
багшань	B A K SH EH NJ
бадаржа	B A D EH ZH EH
бадаруулһан	B A D EH R UUh L HH EH NG
бадлуев	B A D L J EH F
бадлуевай	B A D L J EH V EE
бадмацыбикова	B A D M A C Y VJ I K O V A
базар	B A Z EH R
базаргуруев	B A Z EH Gr Y J EH F
базаржапова	B A Z EH R ZH A P O V A
базаровна	B A Z A R O V N A
баир	B A J EH R
бай	B EE
байба	B EE V EH
байбал	B EE V EH L
байг	B EE Gr
байгаа	B EE Gr AA
байгааб	B EE Gr AA P
байгаагүй	B EE Gr AA Gr UIs
байгаагүйб	B EE Gr AA Gr UIs P
байгаад	B EE Gr AA T
байгаали	B EE Gr AA LJ I
байгаалидаа	B EE Gr AA LJ I D AA
байгаалиин	B EE Gr AA LJ II NG
байгаалитай	B EE Gr AA LJ I T EH
байгаалиһаа	B EE Gr AA LJ I HH AA
байгааш	B EE Gr AA SH
байгал	B EE Gr EH L
байгуулагданхай	B EE Gr UUh L EH G D EH N H EE
байгуулга	B EE Gr UUh L Gr EH
байгуулһан	B EE Gr UUh L HH EH NG
байдаг	B EE D EH K
байдагыень	B EE D EH Gr Y J EH NJ
байдал	B EE D EH L
байдалаар	B EE D EH L AA R
байдалаараашье	B EE D EH L AA R AA SH J EH
байдалай	B EE D EH L EE
байдалда	B EE D EH L D EH
байдалтай	B EE D EH L T EE
байдалыень	B EE D EH L Y J EH NJ
байжа	B EE ZH EH
байлсаатай	B EE L S AA T EE
байна	B EE N EH
байнаб	B EE N EH P
байнабди	B EE N EH B DJ I
байнабта	B EE N EH B T EH
байналши	B EE N EH L SH Y
байнат	B EE N EH T
байнхаар	B EE N H AA R
байра	B EE R EH
байраар	B EE R AA R
байтараа	B EE T EH R AA
байтарнай	B EE T EH R N EE
байхада	B EE H EH D EH
байхадаа	B EE H EH D AA
байхадам	B EE H EH D EH M
байхадань	B EE H EH D EH NJ
байхал	B EE H EH L
байхаш	B EE H EH SH
байхаяа	B EE H EH J AA
байхаһаа	B EE H EH HH AA
байхын	B EE H Y NG
байшан	B EE SH EH NG
байшанай	B EE SH EH N EE
байшангай	B EE SH EH N G EE
байшангуудые	B EE SH EH NG UUh D Y J EH
байшангүй	B EE SH EH N G UIs
байшанда	B EE SH EH N D EH
байшандамнай	B EE SH EH N D EH M N EE
байһан	B EE HH EH NG
байһанаа	B EE HH EH N AA
байһаниинь	B EE HH EH NJ II NJ
байһаншье	B EE HH EH NG SH J EH
байһые	B EE HH Y J EH
байһыень	B EE HH Y J EH NJ
балай	B A L EE
балбар	B A L V EH R
баледэй	B A LJ E D EE
балет	B A LJ E T
балетмейстер	B A LJ E T MJ E J A M S TJ E
балетнэ	B A LJ E T N EH
баллаар	B A L AA R
балтын	B A L T Y NG
балшар	B A L SH EH R
бальжинима	B A LJ ZH Y NJ I M EH
бальжинимаевна	B A LJ ZH Y NJ I M EH J EH V N A
бамба	B A M B EH
банзаровай	B A N Z A R O V EE
бар	B A R
бараандаа	B A R AA N D AA
баргажан	B A R Gr EH ZH EH NG
барилга	B A RJ I L Gr EH
барилгын	B A RJ I L Gr Y NG
барилдаагаар	B A RJ I L D AA Gr AA R
барилдаанай	B A RJ I L D AA N EE
барилдаашадай	B A RJ I L D AA N D EH D EE
барилдаашан	B A RJ I L D AA SH EH NG
баримта	B A RJ I M T EH
барисаата	B A RJ I S AA T EH
бариха	B A RJ I H EH
барихаш	B A RJ I H EH SH
барихаһаа	B A RJ I H EH HH AA
баруун	B A R UUh NG
бархируулһан	B A R HJ I R UUh L HH EH NG
баряа	B A RJ AA
басагад	B A S EH Gr EH T
басагадаараа	B A S EH Gr EH D AA R AA
басагадта	B A S EH Gr EH T T EH
басагадые	B A S EH Gr EH D Y J EH
басагадынь	B A S EH Gr EH D Y NJ
басагамни	B A S EH Gr EH M NJ I
басаган	B A S EH Gr EH NG
басаганиинь	B A S EH Gr EH NJ II NJ
басагантай	B A S EH Gr EH N T EE
басагань	B A S EH Gr EH NJ
басагаханай	B A S EH Gr EH H EH N EE
басагаяа	B A S EH Gr EH J AA
баскетболистнуудай	B A S EH T B O LJ I T EE T
бата	B A T EH
баталжа	B A T EH L ZH EH
бато	B A T EH
батожапов	B A T EH ZH A P O V
баторова	B A T EH R O V A
баясуулба	B A J A S UUh L V EH
баялиг	B A J A LJ I K
баялигууд	B A J A LJ I Gr UUh T
баялигые	B A J A LJ I Gr Y J EH
баян	B A J A NG
баянгаза	B A J A NG EH Z EH
баянгазада	B A J A NG EH Z EH D EH
баяр	B A J EH R
баяраа	B A J A R AA
баярай	B A J A R EE
баярлааб	B A J EH R L AA P
баярлаабди	B A J EH R L EH V AA R NJ I
баярта	B A J EH R T EH
баяртайб	B A J EH R T EE P
баяртайбди	B A J EH R T Y NJ I
баярто	B A J EH R T EH
баяртуевна	B A J EH R T Uh J E V N A
баярые	B A J EH R Y J EH
баясан	B A J A S EH NG
баясуулха	B A J A S UUh L H EH
баһа	B A HH EH
баһаа	B A HH AA
баһаашье	B A HH AA SH J EH
баһал	B A HH EH L
бекмамбетовэй	B E K M A M BJ E T O V EE
би	BJ I
библиотекарь	BJ I B LJ I O TJ E K EH RJ
библиотекын	BJ I B LJ I O TJ E K Y N
бидэ	BJ I D EH
бидэнтэеэ	BJ I D EH N T EH J EE
бидэнэй	BJ I D EH N EE
бии	BJ II
биибди	BJ II B DJ I
биил	BJ II L
билет	BJ II LJ E T
биолог	B O N O L Gr EH
бирагүйхэн	B I R EH Gr UIs H EH NG
бирма	BJ I R M EH
бишыхан	B I SH Y H EH NG
бишье	BJ II SH J EH
блогой	B L O Gr EE
блогоор	B L O Gr OOh R
богонихон	B O Gr EH NJ I H EH NG
бододог	B O D EH D EH K
бодол	B O D EH L
бодолгодо	B O D EH L Gr EH D EH
бодолдоо	B O D EH L D OOh
бодолнууд	B O D EH L N UUh T
бодолоор	B O D EH L OOh R
бодолтой	B O D EH L T EE
бодолые	B O D EH L Y J EH
бодонгууд	B O D EH N G UUh T
бодоод	B O D OOh T
бодото	B O D EH T EH
бодоходо	B O D EH H EH D EH
бодхоогоо	B O D H OOh Gr OOh
бодхоогоод	B O D H OOh Gr OOh T
болбосон	B O L V EH S EH NG
болбосоролдо	B O L V EH S EH R EH L D EH
болбосоролой	B O L V EH S EH R EH L EE
болгогдоо	B O L Gr EH G D OOh
болгогдоһон	B O L Gr EH G D EH HH EH NG
болгожо	B O L Gr EH ZH EH
болгохо	B O L Gr EH H EH
болгоһон	B O L Gr EH HH EH NG
болижо	B O LJ I ZH EH
болингүйгөөр	B O LJ I NG EH Gr UIs Gr OOs R
болобо	B O L EH V EH
болобол	B O L EH V EH L
болодог	B O L EH D EH K
боложо	B O L EH ZH EH
боложол	B O L EH ZH EH L
боломжонууд	B O L EH M ZH EH T
боломжонуудые	B O L EH M ZH EH N UUh D Y J EH
боломжотой	B O L EH M ZH EH T EE
боломоор	B O L EH M OOh R
болон	B O L EH NG
болоно	B O L EH N EH
болонолши	B O L EH N EH L SH Y
болонхой	B O L EH N H EE
болонхойб	B O L EH N H EE P
болонхойбди	B O L EH N H EE B DJ I
болоо	B O L OOh
болообди	B O L EH B DJ I
болоогүй	B O L OOh Gr UIs
болоод	B O L OOh T
болотор	B O L EH T EH R
болохо	B O L EH H EH
болохоб	B O L EH H EH P
болохогүй	B O L EH H EH Gr UIs
болохогүйнь	B O L EH H EH Gr UIs
болоходоо	B O L EH H EH D OOh
болохош	B O L EH H EH SH
болохынь	B O L EH H Y NJ
болошонхой	B O L EH SH EH N H EE
болошоо	B O L EH SH OOh
болошооб	B O L EH SH OOh P
болошоод	B O L EH SH OOh T
болоһон	B O L EH HH EH NG
болоһоншье	B O L EH HH EH NG SH J EH
болоһоор	B O L EH HH OOh R
болоһыень	B O L EH HH Y J EH NJ
болхоева	B O L H O J EH V A
большой	B O LJ M EE
боом	B OOh M
борбилоо	B O R VJ I L OOh
борголовтоной	B O R Gr EH L EH F T EH N EE
борис	B O RJ I S
борисович	B O RJ I S O VJ I CH
борисовна	B O RJ I S O V N A
борисовтай	B O RJ I S O F T EE
боро	B O R EH
бороо	B O R OOh
бороотой	B O R OOh T EE
будаина	B Uh D A I N A
будда	B Uh D D EH
буддизм	B Uh DJ I Z M
буддын	B Uh D EH N UUs NG
будущего	B Uh D Uh SCH E V Gr EH
бузинаева	B Uh ZJ I N A J EH V A
бузинаевагай	B Uh ZJ I N A J E V A Gr EE
буйлуулаа	B UIh L UUh L AA
буйлуулдаг	B UIh L UUh L D EH K
булаг	B Uh L EH G
булагай	B Uh L EH Gr EE
булагууд	B Uh L EH Gr UUh T
булагһаань	B Uh L EH G HH AA NJ
булад	B Uh L EH T
буладай	B Uh L EH D EE
булат	B Uh L EH T
булгилһан	B Uh L GJ I L HH EH NG
булта	B Uh L T EH
бултадаа	B Uh L T EH D AA
бултал	B Uh L T EH L
бултанайнгаа	B Uh L T EH N EE NG AA
бултанииемнай	B Uh L T EH NJ II J EH M N EE
бултыемнай	B Uh L T Y J EH M N EE
буляалдалгын	B Uh LJ A L D EH L Gr Y N UUs NG
бурхад	B Uh R H EH T
бурхан	B Uh R H EH NG
бурханай	B Uh R H EH N EE
бурхандаа	B Uh R H EH N D AA
буряад	B Uh RJ AA T
буряадаар	B Uh RJ AA D AA R
буряадаараа	B Uh RJ AA D AA R AA
буряадай	B Uh RJ AA D EE
буряадаймнай	B Uh RJ AA D EE M N EE
буряадууд	B Uh RJ AA D UUh T
буряадуудай	B Uh RJ AA D UUh D EE
буряадуудбди	B Uh RJ AA D UUh D B DJ I
бурятия	B Uh RJ A TJ I J A
буряяадууд	B Uh RJ AA D UUh T
бусааха	B Uh S AA H EH
бусад	B Uh S EH T
бусадшье	B Uh S EH D SH J EH
бусадһаа	B Uh S EH D HH AA
бусажа	B Uh S EH ZH EH
бусалжа	B Uh S EH L ZH EH
бусаха	B Uh S EH H EH
бусахань	B Uh S EH H EH NJ
бусашаһан	B Uh S EH SH EH HH EH NG
бута	B Uh T EH
буудажархеоб	B UUh D EH ZH EH R HJ OOh P
буудажархёоб	B UUh D EH ZH EH R HJ OOh P
буулгагша	B UUh L Gr EH G SH EH
буулгадаг	B UUh L Gr EH D EH K
буулгажа	B UUh L Gr EH ZH EH
буулгаха	B UUh L Gr EH H EH
буулгахада	B UUh L Gr EH H EH D EH
буулгаһан	B UUh L Gr EH HH EH NG
буулгуулдаг	B UUh L Gr UUh L D EH K
буусада	B UUh S EH D EH
бууһан	B UUh HH EH NG
бухгалтер	B Uh H EH L T EH R
бухы	B Uh H Y
буянгаар	B Uh J EH N G AA R
бшуу	B SH UUh
бэ	B E
бэдэрдэг	B E D EH R D EH K
бэдэрхэдэнь	B E D EH R H EH D EH NJ
бэдэрхэеэ	B E D EH R H EH J EE
бэе	B E J EH
бэедэ	B E J EH D EH
бэедэшье	B E J EH D EH SH J EH
бэедээ	B E J EH D EE
бэелүүлсэһэн	B E J EH L UUs L HH EH NG
бэелүүлхын	B E J EH L UUs L H Y NG
бэелүүлхэ	B E J EH L UUs L H EH
бэелүүлхэеэ	B E J EH L UUs L H EH J EE
бэелүүлэгдэхэ	B E J EH L UUs L EH G D EH H EH
бэелүүлэлсэһэн	B E J EH L UUs L EH HH EH L HH EH NG
бэетэй	B E J EH T EE
бэеын	B E J Y NG
бэеынгээ	B E J Y NG G EE
бэеэ	B E J EE
бэзэ	B E Z EH
бэлдэгшэд	B E L D EH G SH J EH
бэлдээтэй	B E L D EE T EE
бэлдэһэн	B E L D EH HH EH NG
бэлиг	B E LJ I K
бэлигтэй	B E LJ I K T EE
бэлигэй	B E LJ I Gr EE
бэлигээ	B E LJ I Gr EE
бэлшээринүүднай	B E L SH EH RJ I N UUs D EE
бэлшээритэй	B E L SH EH RJ I T EE
бэлшээриһээ	B E L SH EH RJ I HH EE
бэлэг	B E L EH K
бэлэглээ	B E L EH G L EE
бэлэглэһэн	B E L EH G L EH HH EH NG
бэлэгүүд	B E L EH Gr UUs T
бэлэй	B E L EE
бэлэйбди	B E L EE B DJ I
бэлэн	B E L EH NG
бэрхэ	B E R H EH
бэрхэтэй	B E R H EH T EE
бэрхэшээлнүүд	B E R H EH SH EE L N UUs T
бэрхэшээлнүүдһээ	B E R H EH SH EE L N UUs D HH EE
бэшэ	B E SH EH
бэшэб	B E SH EH P
бэшэгдэһэн	B E SH EH G D EH HH EH NG
бэшэгэй	B E SH EH Gr EE
бэшэгүүд	B E SH EH Gr UUs T
бэшэжэ	B E SH EH ZH EH
бэшэжэрхидэг	B E SH EH ZH EH R HJ I D EH K
бэшэн	B E SH EH NG
бэшэшье	B E SH EH SH J EH
бэшээ	B E SH EE
бэшүүрэй	B E SH EH R EE
бүгэдые	B Us Gr EH D Y J EH
бүгэдэ	B Us Gr EH D EH
бүлгэм	B Us L Gr EH M
бүлын	B Us L Y NG
бүлынгөө	B Us L Y NG G OOs
бүлэ	B Us L EH
бүлэг	B Us L EH K
бүлэгтэ	B Us L EH G T EH
бүлэгтэеэ	B Us L EH G T EH J EE
бүлэгынь	B Us L EH Gr Y NJ
бүлэгэй	B Us L EH Gr EE
бүлэдэ	B Us L EH D EH
бүлэмни	B Us L EH M NJ I
бүри	B Us RJ I
бүридхэмэл	B Us RJ I R H EH M EH L
бүридэһэн	B Us RJ I D EH HH EH NG
бүридүүлэгдэһэн	B Us RJ I D UUs L EH G D EH HH EH NG
бүтэдэг	B Us T EH D EH K
бүтээгдэнхэй	B Us T EE G D EH N H EE
бүтээгээд	B Us T EE Gr EE T
бүтээлнүүдые	B Us T EE L N UUs D Y J EH
бүтээлнүүдээрээ	B Us T EE L N UUs D EE R EE
бүтээлэй	B Us T EE L EE
бүтээхэеэ	B Us T EE H EH J EE
бүтээһэн	B Us T EE HH EH NG
бүхы	B Us H Y
бүхыдэнь	B Us H Y D EH NJ
бүхыдөө	B Us H Y D OOs
бүхые	B Us H Y J EH
бүхэдэлхэйн	B Us H EH D EH L H EE NG
бүхэн	B Us H EH NG
бүхэндэ	B Us H EH N D EH
бүхэниие	B Us H EH NJ II J EH
бүхэниинь	B Us H EH NJ II NJ
бүхэнэй	B Us H EH N EE
бүүбэйнүүд	B UUs V EE N UUs T
бүһэтэй	B Us HH EH T EE
бөө	B OOs
вазын	V A Z Y NG
валентина	V A LJ E N TJ I N T EH
валерий	V A LJ E RJ I J
валерьевна	V A LJ E RJ J E V N A
валиджан	V A LJ I D ZH A NG
вениамин	VJ E NJ I A MJ I NG
вера	VJ E R EH
вероника	VJ E R O NJ I K EH
ветеран	VJ E TJ E R A NG
ветеринар	VJ E TJ E RJ I N A R A
видеоролик	VJ DJ E O R O LJ I K
винчиин	VJ I N CH II NG
виртаненэй	VJ I R T A NJ EH N EE
владимир	V L A DJ I M I R
выставкэ	V Y S T A F K EH
вьетнам	VJ E T N A M
вячеслав	VJ A CH E S A L V A
габаһаа	G A V EH HH AA
габьяа	G A VJ J AA
габьяата	G A VJ J AA T EH
габьяатай	G A VJ J AA T EE
гавриловна	G A V RJ I L O V A
гадаада	G A D AA D EH
гадна	G A D N EH
газаа	G A Z AA
газаашаа	G A Z AA SH AA
газар	G A Z EH R
газараа	G A Z EH R AA
газарай	G A Z EH R EE
газарнай	G A Z EH R EE
газарнууд	G A Z EH R N UUh T
газарнууднай	G A Z EH R N UUh D N EE
газарнуудта	G A Z EH R N UUh T T EH
газарта	G A Z EH R T EH
газартаа	G A Z EH R T AA
газартань	G A Z EH R T EH NJ
гайтай	G EE T EE
гайхаа	G EE H AA
гайхааб	G EE H AA P
гайхалтай	G EE H EH L T EE
гайхамшагта	G EE H EH M SH EH T K EH
гайхуулаа	G EE H UUh L AA
гал	G A L
галерей	G A LJ E RJ J EH
галнууд	G A L N UUh D
ганса	G A N S EH
гансал	G A N S EH L
гансалтайхан	G A N S EH L T EE H EH NG
гансам	G A N S EH M
гансахан	G A N S EH H EH NG
гансашье	G A N S EH SH J EH
гар	G A R
гараа	G A R AA
гараад	G A R AA T
гарагшад	G A R EH G SH EH T
гарадаг	G A R EH D EH K
гарадаггүй	G A R EH D EH Gr UIs
гаража	G A R EH ZH EH
гаралхидни	G A R EH L HJ I D NJ I
гаран	G A R EH NG
гаранхай	G A R EH NG H EE
гаратараа	G A R EH T EH R AA
гараха	G A R EH H EH
гарахаар	G A R EH H AA R
гарахаб	G A R EH H EH P
гарашаба	G A R EH SH EH V EH
гарашооб	G A R EH SH OOh P
гараһан	G A R EH HH EH NG
гарбал	G A R V EH L
гарбалтай	G A R V EH L T EE
гарбалтанай	G A R V EH L T EH N EE
гарбалынь	G A R V EH L Y NJ
гаргаа	G A R Gr AA
гаргааб	G A R Gr AA P
гаргадаггүй	G A R Gr EH D EH Gr UIs
гарганхай	G A R EH N H EE
гаргашалагдадаг	G A R Gr EH SH EH L D EH G D EH G
гарни	G A R N GJ I
гастрольдо	G A S EH R B LJ L EH
гатыповнагай	G A T Y P O V N EE
гаутамаарүндэһэлһэн	G A Us T A M AA R Us N D EH HH EH L HH EH NG
гашей	G A SH EE
гашейн	G A SH EE NG
герируд	GJ E RJ I R Uh T
германиин	GJ E R M A NJ II NG
герой	GJ E R O J
гильменд	GJ I LJ M E N D NG
гималайн	GJ I M A L EE NG
гимназиин	GJ I M N A ZJ II NG
гитис	GJ I TJ I S
гоелто	G O J EH L T EH
гоеор	G O J OOh R
гол	G O L
голливудта	G O LJ I V Uh J I L D T AA
гомбо	G O M B EH
гомдол	G O M D EH L
гонзогорхон	G O N Z EH G H EH R H EH NG
гончикова	G O N CH I K O V A
горитойхон	G O RJ I T EE H EH NG
городто	G O R EH T T EH
горского	G O R S O RJ S K O V O
гостелерадиокомпани	G O S TJ E LJ E R A DJ I O
гоё	G O J EH
гоёор	G O J OOh R
гоёшоодог	G O J EH SH OOh D EH K
градус	G R A D Uh S
грамм	G R A M
гранпри	G R A N P RJ I
графика	G R A FJ I K EH
григорий	G Uh RJ I RJ I
григорьевна	G RJ I K Uh R J E V N A
гуйлаа	G UIh L AA
гуйлтыень	G UIh L T Y J EH NJ
гуйһан	G UIh HH EH NG
гуламта	G Uh L EH M T EH
гунхуулхагүй	G Uh N H UUh L H EH D UIs
гурба	G Uh R V EH
гурбадахи	G Uh R V EH D EH HJ I
гурбан	G Uh R V EH NG
гурбанһаа	G Uh R V EH N HH AA
гурбатайһаань	G Uh R V EH T EE HH AA NJ
гурбахан	G Uh R V EH H EH NG
гурэнэй	G Uh R EH N EE
гусиноозерск	G Uh SJ I N O ZJ OOh R
гутал	G Uh T EH L
гутаповна	G Uh T A P O V N A
гушанартай	G Uh SH EH N EH R T EE
гэбэл	G E V EH L
гэбэшье	G E V EH SH J EH
гэгшын	G E G SH Y NG
гэгшэд	G E G SH EH D
гэгшэдэй	G E G SH EH D EE
гэдэг	G E D EH K
гэдэргээ	G E D EH R Gr EE Gr EE
гэжэ	G E ZH E
гэжэшье	G E ZH E J EH
гэлдэнэбди	G E L D EH N EH
гэлсэдэг	G E L S EH D EH K
гэлсээбди	G E L S EE B DJ I
гэмэ	G E M EH
гэн	G O NG
гэнтэ	G E N T EH
гэнэ	G E N EH
гэр	G EH R
гэрнүүд	G EH R N UUs T
гэртэ	G EH R T EH
гэртэй	G EH R T EE
гэртэнь	G EH R T EH NJ
гэртэхиндэнь	G EH R T EH HJ I N D EH NJ
гэртэхиндээшье	G EH R T EH HJ I N D EE SH J EH SH EE SH J EH
гэртэхиншье	G EH R T EH HJ I N NJ I J EH NJ
гэртэхинэй	G EH R T EH HJ I N EE
гэртэхинэйнгээ	G EH R T EH HJ I N EE NG G EE
гэртэхинээ	G EH R T EH HJ I N EE
гэртээ	G EH R T EE
гэршэлбэ	G EH R SH EH L V EH
гэршэлгэнүүд	G EH R SH EH L Gr UUs N D EH N UUs T
гэршэлдэг	G EH R SH EH L D EH K
гэршэлэн	G EH R SH EH L EH NG
гэршэлээ	G EH R SH EH L EE
гэрэй	G EH R EE
гэрэйнгээ	G EH R EE NG G EE
гэрэйхи	G EH R EE HJ I
гэрэл	G EH R EH L
гэрэлтэ	G EH R EH L T EH
гэрээшье	G EH R EE SH J EH
гэхэ	G E H EH
гэхэдэ	G E H EH D EE
гэхэдэнь	G E H EH D EH NJ
гэхэдээ	G E H EH D EE
гэшүүн	G E SH UUs NG
гээ	G EE
гээбы	G EE V Y
гээд	G EE T
гээшье	G EE SH J EH
гээшэ	G EE SH EE
гээшэб	G EE SH EH P
гээшэбибди	G EE SH EH VJ I B DJ I
гээшэбииб	G EE SH E VJ II P
гээшэбта	G EE SH EH P T EH
гээшэмнай	G EE SH EH M N EE
гэһэн	G E HH EH NG
гэһэндэл	G E HH EH N D EH L
гэһээмни	G E HH EE M NJ I
гү	G Us
гүйгээб	G UIs Gr EE P
гүйдэлтэйгөөр	G UIs D EH L T EE Gr OOs R
гүйжэ	G UIs ZH EH
гүйсэдхэдэг	G UIs S EH T H EH D EH G
гүйсэдхэжэ	G UIs S EH T H EH ZH EH
гүйсэдхэнэ	G UIs S EH T H EH N EH
гүйсэдхэхэдэ	G UIs S EH T H EH H EH D EE
гүйсэдхэһэн	G UIs S EH T H EH HH EE NG
гүлмэрхэн	G Us L M EH R V EH NG
гүн	G Us NG
гүнзэгы	G Us N Z EH Gr Y
гүнзэгыгөөр	G Us N Z EH Gr Y Gr OOs R
гүнзэгырүүлээб	G N UUs HH EH R Y J EH L EE P
гүрэн	G Us R EH NG
гүрэндэ	G Us R EH N D EH
гүрэнэй	G Us R EH N EE
гүрэнүүдэй	G Us R EH N UUs D EE
гүү	G UUs
гүүлэжэрхидэг	G UUs L EH ZH E R HJ I D EH K
гүүртэнүүдэй	G UUs R T EH N UUs D EE
да	D A
даа	D AA
даагша	D AA G SH EH
даамай	D AA M EE
даб	D A P
даба	D A V EH
дабажа	D A ZH EH
дабашагүй	D A V EH SH EH Gr UIs
дабтагдадаг	D A P T EH G D EH D EH K
дабтагдадагшье	D A P G EH D EH G D EH D EH Gr UIs
дабтажал	D A P T EH ZH EH L
дабтамаар	D A P T EH M AA R
дабташагүй	D A P T AA SH EH Gr UIs
дагаева	D A Gr A J EH V A
дай	D EE
дайда	D EE D EH
дайдаар	D EE D AA R
дайдада	D EE D EH D EH
дайдань	D EE D EH NJ
дайдаяа	D EE D EH J AA
дайдынгаа	D EE D Y NG G AA
дайнай	D EE N EE
дайралдаа	D EE R EH L D AA
дайралдадаг	D EE R EH L D EH D EH K
дайралдаһан	D EE R EH L D EH HH EH NG
дайралсадаг	D EE R EH L S EH D EH K
дайраха	D EE R EH H EH
дайшалхы	D EE SH EH L H Y
далаад	D A L AA T
далайгаа	D A L EE Gr AA
далайдаа	D A L EE D AA
далаймни	D A L EE M NJ I
далайн	D A L EE NG
далайһаашье	D A L EE HH AA SH J EH
далан	D A L EH NG
далахай	D A L EH H EE
далахаймни	D A L EH H EE M NJ I
далахайн	D A L EH H EE NG
далбаева	D A L V A J EH V A
далбаевтай	D A L V A J EH F T EH T EE
далбаевтан	D A L V A J EH F T EH T EH NJ
дали	D A LJ I
даллан	D A L EH NG
дамба	D A M B EH
дамдинов	D A M DJ I N O V
дамдиновагай	D A M DJ I N O V A Gr EE
дамдиновна	D A M DJ I N O V A
дамжуулагдаа	D A M ZH UUh L Gr AA G D AA
дамжуулагдаһан	D A M ZH UUh L EH G D EH HH EH NG
дамжуулдаг	D A M ZH UUh L D EH K
дамжуулха	D A M ZH UUh L H EH
дамжуулһан	D A M ZH UUh L HH EH NG
дангина	D A N GJ I N EH
дангинанаараа	D A N GJ I N EH N AA R AA
дандар	D A N D EH R
дансануудаа	D A N S EH N UUh D AA
дансаранов	D A N S A R O V O F
дарга	D A R Gr EH
дари	D A RJ I
дарима	D A RJ I M A
дармаев	D A R M A J EH F
дармаевтанайнгаа	D A R M A J EH F T EH N EE NG AA
даруу	D A R Uh
даруулаагүй	D A R UUh L AA Gr UIs
дасан	D A S EH NG
дасанай	D A S EH N EE
дасангууд	D A S EH N G UUh T
дасанда	D A S EH N D EH
дахажа	D A H EH ZH EH
дахин	D A HJ I NG
дахуулаад	D A L UUh L AA T
дахуулха	D A H UUh L H EH
дахяад	D A HJ AA T
дашарамдуулан	D A SH EH R EH M D UUh L EH NG
дашиевич	D A SH Y J O VJ I CH
даяар	D A J AA R
декабриин	DJ E K A P RJ II NJ
декадада	DJ E K A D EH D EH
джон	D ZH O NG
диилэнхи	DJ II L EH N H I
диилэнэ	DJ II L EH N EH
диилээ	DJ II L EE
директор	DJ I RJ E K T O R
добтолгоһоо	D O P T EH L Gr O HH OOh
долгилхые	D O L GJ I L H Y J EH
долгито	D O L GJ I T EH
должон	D O L ZH EH NG
долоогоно	D O L OOh Gr EH N EH
долоон	D O L OOh NG
домог	D O M EH K
домто	D O M T EH
дон	D O NG
дондок	D O N D EH K
дондокович	D O N D EH K O V I CH
донна	D O N EH
доогуур	D OOh Gr EH R
доодо	D OOh D EH
доржо	D O R ZH EH
доро	D O R EH
доройтолго	D O R EE T EH L Gr EH
дороо	D O R OOh
дороһоо	D O R EH HH OOh
досоо	D O S OOh
досоомни	D O S OOh M NJ I
дотор	D O T EH R
доторой	D O T EH R EE
доторойнгоо	D O T EH R EE NG AA
дохин	D O HJ I NG
дошхон	D O SH H EH NG
доһолгоно	D O HH EH L Gr EH N EH
доһолоод	D O HH EH L OOh T
драмын	D R A M Y NG
дугы	D Uh Gr Y
дулаан	D Uh L AA NG
дулаахан	D Uh L AA H EH NG
дулааханаар	D Uh L AA H AA R
дулдыдана	D Uh L D Y D EH N EH
дулма	D Uh L M EH
дулмаһаа	D Uh L M A HH AA
дунда	D Uh N D EH
дундажа	D Uh N D EH ZH EH
дундаршагүй	D Us N D EH R SH EH Gr UIs
дураар	D Uh R AA R
дураараа	D Uh R AA R AA
дурадхагдаһан	D Uh R EH T H EH G D EH HH E NG
дурадхалнууд	D Uh R EH T H EH L N UUh T
дурадхаһан	D Uh R EH T H EH HH EH NG
дуран	D Uh R EH NG
дуранай	D Uh R EH N EE
дурасхаалай	D Uh R EH S H AA L EE
дуратай	D Uh R EH T EE
дуратайб	D Uh R EH T EE P
дуратайгаар	D Uh R EH T EE Gr AA R
дуратайл	D Uh R EH T EE L
дурданабди	D Uh R D EH N EH B DJ I
дурдая	D Uh R D EH J AA
дурлаһан	D Uh R L EH HH EH NG
дурлуулһан	D Uh R L UUh L HH EH NG
дуталдахада	D Uh T EH L D EH D EH
дутуу	D Uh T UUh
дутуугүй	D Uh T UUh Gr UIs
дуу	D UUh
дуугай	D UUh Gr EE
дуугаргажа	D UUh Gr EH R Gr EH ZH EH
дуугардаг	D UUh Gr EH R D EH K
дуугарха	D UUh Gr EH R H EH
дуулааб	D UUh L AA P
дууладаг	D UUh L EH D EH K
дуулажа	D UUh L EH ZH EH
дуулалдаа	D UUh L EH L D AA
дуулан	D UUh L EH NG
дуулана	D UUh L EH N EH
дууланалби	D UUh L EH N EH L VJ I
дуулдана	D UUh L D EH N EH
дуунууд	D UUh N UUh T
дуунуудаа	D UUh N UUh D AA
дуунуудые	D UUh N UUh D Y J EH
дуутай	D UUh T EE
дууша	D UUh SH AA
дуушад	D UUh SH EH T
дуушан	D UUh SH EH NG
дууһаад	D UUh HH AA T
дууһаха	D UUh HH EH H EH
дуһаажа	D Uh HH AA ZH EH
дэбисхэр	D E VJ I S H EH R
дэбтэрнүүд	D E B T EH R N UUs T
дэгэл	D E Gr EH L
дэгэлтэй	D E Gr EH L T EE
дэлгэбэ	D E L Gr EH V EH
дэлгэн	D E L Gr EH NG
дэлгэнхэй	D E L Gr EH N H EE
дэлгэрдэг	D E L Gr EH R D EH K
дэлгэрнэ	D E L Gr EH R N EH
дэлгэрүүлэгдэбэ	D E L Gr EH R UUs L EH G D EH V EH
дэлгээгдэнхэй	D E L Gr EE G D EH N H EE
дэлгээд	D E L Gr EE D
дэлгэһэн	D E L Gr EH HH EH NG
дэлгүүрнүүдэй	D E L Gr UUs R N UUs D EE
дэлхэй	D E L H EE
дэлхэйгээр	D E L H EE Gr EE R
дэлхэйгээршье	D E L H EE Gr EE R SH J EH
дэлхэйдэ	D E L H EE D EH
дэлхэйдээрэ	D E L H EE D EE R EH
дэлхэйе	D E L H EE J EH
дэлхэйн	D E L H EE NG
дэмбэрэлтэй	D E M B EH R EH L T EE
дэмжэдэг	D E M ZH EH D EH K
дэмжэлгэнь	D E M ZH EH L Gr EH NJ
дэмжэлгэһээ	D E M ZH EH L Gr EH HH EE
дэргэдэ	D E R Gr EH D EH
дээгүүр	D EE Gr UUs R
дээдын	D EE D Y NG
дээдэ	D EE D EH
дээрэ	D EE R EH
дээрэнь	D EE R EH NJ
дээрээ	D EE R EE
дээрэһээнь	D EE R EH HH EE NJ
дээшэн	D EE SH EH NG
дээшэнь	D EE SH EH NJ
дээшээ	D EE SH EE
дүй	D UIs
дүлөөр	D Us L OOs R
дүн	D Us NG
дүнгүүдээр	D Us NG G UUs D EE R
дүрбэдэхи	D Us R V EH D EH HJ I
дүрбэлжэн	D Us R V EH L ZH EH NG
дүрбэн	D Us R V EH NG
дүримые	D Us RJ I M Y J EH
дүршэл	D Us R SH EH L
дүршэлөөрөө	D Us R SH EH L OOs R OOs
дүрэ	D Us R EH
дүрэеэ	D Us R EH J EE
дүрэтэй	D Us R EH T EE
дүтын	D Us T Y NG
дүтэ	D Us T EH
дүтэлжэ	D Us T EH L ZH EH
дүтөөр	D Us T OOs R
дүхэригһөө	D Us H EH RJ I G HH OOs
дүшэн	D Us SH EH NG
дүшөөд	D Us SH OOs T
дүү	D UUs
дүүгээ	D UUs Gr EE
дүүниинь	D UUs NJ II NJ
дүүнэртэеэ	D UUs N EH R T EH J EE
дүүнэрэймни	D UUs N EH R EE M NJ I
дүүргэбэ	D UUs R Gr EH V EH
дүүргэжэ	D UUs R Gr EH ZH EH
дүүргэнхэй	D UUs R Gr EH N H EE
дүүргэхэ	D UUs R Gr EH H EH
дүүргэхэдэнь	D UUs R Gr EH H EH D EH NJ
дүүргээ	D UUs R Gr EE
дүүргээд	D UUs R Gr EE T
дүүргэһэн	D UUs R Gr EH HH EH NG
дүүрэн	D UUs R EH NG
дүүрэтэр	D UUs R EH T EH R
евгения	J EH V GJ EH NJ I J A
евэ	J E V EH
егорович	J E G O R O VJ I CH
екатерина	J E K A TJ E RJ I N A
елиас	J E LJ I A S
елизэ	J E LJ I Z EH
еохор	J OOh H EH R
ерэгты	J E R EH K T Y
ерэдэг	J E R EH D EH K
ерэдэггүй	J E R EH D EH G Gr UIs
ерэжэ	J E R EH ZH EH
ерэмсээрээ	J E R EH M S EE R EE
ерэн	J E R EH NG
ерэнхэй	J E R EH N H EE
ерэнэ	J E R EH N EH
ерэнэгүй	J E R EH N EH Gr UIs
ерэхэ	J E R EH H EH
ерэхэб	J E R EH H EH P
ерэхэдэнь	J E R EH H EH D EH NJ
ерэхэдээ	J E R EH H EH D EE
ерэхэл	J E R EH H EH L
ерээ	J E R EE
ерээбди	J E R EE B DJ I
ерээд	J E R EE T
ерэһэн	J E R EH HH EH NG
ерүүл	J E R UUs L
ехэ	J E H EH
ехэл	J E H EH L
ехэнхидээ	J E H EH N HJ I D EE
ехэтэ	J E H EH T EH
ехэтэй	J E H EH T EE
ехэхэн	J E H EH H EH NG
ехээр	J E H EE R
еши	J E SH Y
еһоной	J O HH EH N EE
еһотой	J O HH EH T EE
еһотойб	J O HH EH T EE P
жаахан	ZH AA H EH NG
жабай	ZH A V EE
жалсанов	ZH A L S A N O F
жамсаевнатанай	ZH A M S EH J EH V N A T EE
жанрда	ZH A N R D EH
жапович	ZH A P O VJ I CH
жаповичай	ZH A P O VJ I CH EE
жаргал	ZH A R Gr EH L
жаргалай	ZH A R Gr EH L EE
жаргалова	ZH A R Gr A L O V A
жаргалтай	ZH A R Gr EH L T EE
жаргалтайб	ZH A R Gr EH L T EE P
жарган	ZH A R Gr EH NG
жаяг	ZH A J EH K
жизель	ZH E Z E LJ
жиирэй	ZH Y R EE
жирафууд	ZH Y R A F UUh T
журамтай	ZH A R EH M T EE
жэгтэй	ZH E G T EE
жэл	ZH E L
жэлдэ	ZH E L D EH
жэлдээ	ZH E L D EE
жэлнүүд	ZH E L N UUs T
жэлэй	ZH E L EE
жэлэйнгээ	ZH E L EE NG G EE
жэлээр	ZH E L EE R
жэнхэни	ZH E N H EH NJ I
жэргэмэл	ZH E R Gr EH M EH L
жэшээ	ZH E SH EE
жэшээгээр	ZH E SH EE Gr EE R
жэшээлэн	ZH E SH EE L EH NG
жэшээнь	ZH E SH EE NJ
жээрэб	ZH EE R EH P
жюриин	ZH Uh RJ II NG
жүрөөдэһэн	ZH Us R OOs D EH HH EH NG
заабол	Z AA V EH L
заагдадаг	Z AA G D EH D EH K
заадаг	Z AA D EH K
заажа	Z AA ZH EH
заалаар	Z AA L AA R
заанаб	Z AA N EH P
зааниие	Z AA NJ II J EH
заатагүй	Z AA T EH Gr UIs
зааха	Z AA H EH
зааһан	Z AA HH EH NG
забайкалиин	Z A B A J K A LJ II NG
загастай	Z A Gr EH S T EE
зай	Z EE
зайгаа	Z EE Gr AA
зайн	Z EE NG
заказник	Z A K A Z NJ I K
зал	Z A L
залуу	Z A L UUh
залуудаа	Z A L UUh D AA
залуухан	Z A L UUh H EH NG
залуушуулай	Z A L UUh SH UUh L EE
залуушуулда	Z A L UUh SH UUh L D EH
залуушуулые	Z A L UUh SH UUh L Y J EH
залхуурдаг	Z A L H UUh R D EH K
замаар	Z A M AA R
замай	Z A M EE
зан	Z A NG
зандааб	Z A N D AA P
зандин	Z A N DJ I NG
зандинаархиниие	Z A N DJ I N AA R HJ I NJ II J EH
зандинда	Z A N DJ I N D EH
зандиниие	Z A N DJ I NJ II J EH
зандинһаа	Z A N DJ I N HH AA
зандинһаамни	Z A N DJ I N HH AA M NJ I
зантай	Z A N T EE
заншал	Z A N SH EH L
заншалаа	Z A N SH EH L AA
заншалта	Z A N SH EH L T EH
заншалтай	Z A N SH EH L T EE
заншалһаа	Z A N SH EH L HH AA
заочноор	Z A O CH N OOh R
зарим	Z A RJ I M
засаг	Z A S EH K
заха	Z A H EH
захааминай	Z A H AA MJ I N EE
захалаад	Z A H EH L AA T
захалба	Z A H EH L V EH
захяа	Z A HJ AA
заяамни	Z A J AA M NJ I
заяан	Z A J AA NG
заяанай	Z A J AA N EE
зибарева	Z A B A RJ E V A
зободог	Z O V EH D EH K
зобоһон	Z O V EH HH EH NG
зогсожо	Z O K S EH ZH EH
зогсон	Z O K S EH NG
зодоо	Z O D OOh
зол	Z O L
золгоо	Z O L Gr OOh
золгооб	Z O L Gr OOh P
золгохобиб	Z O L Gr EH H EH V I P
золгоһон	Z O L Gr O HH EH NG
золтойдоо	Z O L T EE D OOh
зомнайшье	Z Uh M N EE SH J EH
зон	Z O NG
зондо	Z O N D EH
зондоо	Z O N D OOh
зониие	Z O NJ II J EH
зоной	Z O N EE
зонойнгоо	Z O N EE NG G OOh
зоноо	Z O N OOh
зонтой	Z O N T EE
зонуудые	Z O N UUh D Y J EH
зонһоо	Z O N H OOh
зориг	Z O RJ I K
зорижо	Z O RJ I ZH EH
зорилго	Z O RJ I L Gr EH
зорилгодо	Z O RJ I L Gr EH D EH
зорилготой	Z O RJ I L Gr EH T EE
зориһон	Z O RJ I HH EH NG
зориһоные	Z O RJ I HH EH N Y J EH
зорюулагдаһан	Z O RJ UUh L EH G D EH HH EH NG
зорюулха	Z O RJ UUh L H EH
зорюулһан	Z O RJ UUh L HH EH NG
зосоо	Z O S OOh
зохеолнууд	Z O HJ OOh L N UUh T
зохидхон	Z O HJ I T H EH NG
зохёогшо	Z O HJ OOh K SH EH
зохёол	Z O HJ OOh L
зохёолнууд	Z O HJ OOh L N UUh T
зохёолнуудаа	Z O HJ OOh L N UUh D AA
зохёолнуудые	Z O HJ OOh L N UUh D Y J EH
зохёолой	Z O HJ OOh L EE
зохёолшод	Z O HJ OOh L SH EH T
зохёолшодой	Z O HJ OOh L SH EH D EE
зохёолые	Z O HJ OOh L Y J EH
зохёохо	Z O HJ OOh H EH
зохёохы	Z O HJ OOh H Y
зохёоһон	Z O HJ OOh HH EH NG
зубхиёо	Z Uh P HJ I J OOh
зугаа	Z Uh Gr AA
зугаатай	Z Uh Gr AA T EE
зугааша	Z Uh Gr AA SH EH
зугадаа	Z Uh Gr EH D AA
зузаан	Z Uh Z AA NG
зунай	Z Uh N EE
зундаа	Z Uh N D AA
зурааша	Z Uh R AA SH AA
зураашанайруулагшаар	Z Uh R AA SH EH N EE R UUh L EH K SH AA R
зураашадаар	Z Uh R AA SH EH D AA R
зураг	Z Uh R EH K
зурагай	Z Uh R EH Gr EE
зураглагдана	Z Uh R EH G L EH G D EH N EH
зураглажа	Z Uh R EH G L EH ZH EH
зурагта	Z Uh R EH K T EH
зурагууд	Z Uh R EH Gr UUh T
зурагуудай	Z Uh R EH Gr UUh D EE
зурагуудтай	Z Uh R EH Gr UUh T T EE
зурана	Z Uh R EH N EH
зураха	Z Uh R EH H EH
зургаадахи	Z Uh R Gr AA D EH HJ I
зургаанда	Z Uh R Gr AA N D EH
зуун	Z UUh NG
зуураа	Z UUh R AA
зууршалагдаһан	Z UUh R SH EH L EH Gr D EH HH EH NG
зэбсэгүүдые	Z E P S EH Gr UUs D Y J EH
зэдын	Z E D Y NG
зэдэлшэхэдэл	Z E D EH L SH EH H EH D EH L
зэдэлһэн	Z E D EH L HH EH NG
зэмэлнэб	Z E M EH L N EH P
зэргэ	Z E R Gr EH
зэргэдэ	Z E R Gr EH D EH
зэрлиг	Z E R LJ I K
зээ	Z EE
зүб	Z Us P
зүбшөөл	Z Us P SH OOs L
зүг	Z Us K
зүгын	Z Us Gr Y NG
зүгэй	Z Us Gr EE
зүгһөө	Z Us G HH OOs
зүгөөр	Z Us Gr OOs R
зүдхэли	Z Us D H EH LJ I
зүдхэлиин	Z Us D EH LJ II NG
зүжэг	Z Us ZH EH K
зүжэгтэ	Z Us ZH EH K T EH
зүжэгшэн	Z Us ZH EH K SH EH NG
зүжэгынь	Z Us ZH EH Gr Y NJ
зүжэгүүдтэ	Z Us ZH EH Gr UUs T T EH
зүйлнүүд	Z UIs L N UUs T
зүлхэ	Z Us L H EH
зүлхэйн	Z Us L H EE NG
зүрхые	Z Us R H Y J EH
зүрхэ	Z Us R H EH
зүрхэмни	Z Us R H EH M NJ I
зүрхэнэйм	Z Us R H EH N EE M
зүрхэнэйнгөө	Z Us R H EH N EE NG G OOs
зүрхэнһөө	Z Us R H EH N HH OOs
зүүн	Z UUs NG
зөөлэн	Z OOs L EH NG
зөөри	Z OOs RJ I
зөөриин	Z OOs RJ II NG
зөөритэй	Z OOs RJ I T EE
зөөхэй	Z OOs H EE
и	I
ивалгын	I V EH L Gr Y NG
иванов	I V A N O F
ивановна	I V A N O V N A
ивановой	I V A N O V EE
ивановтой	I V A N O F T EE
ивато	I V A T O
из	I Z
иигэжэ	II Gr EH ZH EH
иигэжэл	II Gr EH ZH EH L
иигээд	II Gr EE T
иимэ	II M EH
иимэрхүү	II M EH R H UUs
иишэ	II SH EH
иишээ	II SH EE
илагшадай	I L EH K SH EH D EE
илажа	I L EH ZH EH
илангаяа	I L EH NG G A J AA
илгарнабди  I L Gr EH R N EH B DJ I
импери	I M PJ E RJ I
империин	I M PJ E RJ II NG
инаг	I N EH K
инагуудай	I N EH Gr UUh D EE
индостанай	I N D EH S T A N EE
индус	I N D Uh S
индустриальна	I N D Uh S T RJ I A LJ N EH
инженербиотехнологой	I N ZH EH NJ E R BJ I O TJ E H N O L EH G EE
иннокентьевич	I N N O KJ E N TJ J E VJ I CH
иннокентьевна	I N N O KJ E N TJ J E V N A
институдай	I N S TJ I T Uh D EE
институдта	I N S TJ I T Uh T T EH
институт	I NJ S T TJ I T Uh T
интернадта	I N T E R N A T T EH
интернедтэ	I N T E R N EH T T EH
интернет	I N T E R N EH T
информ	I N F O R M
ирина	I RJ I N EH
исимбаев	I SJ I M B A J E F
искусство	I S K Uh S S T V EH
искусствын	I S K Uh S S T V Y NG
июниин	I J Uh NJ II NG
июниинь	I J Uh NJ II NJ
кабул	K A V Uh L
камбоджа	K A M B O D ZH EH
канадын	K A N A D Y NG
каникулы	K A NJ I K Uh L Y
катя	K A TJ A
кексэ	KJ E K S EH
килограмм	KJ I L O G R A M
кино	KJ I N O
киногоо	KJ I N O Gr OOh
кинодо	KJ I N O D EH
киномеханигаар	KJ I N O MJ E H A NJ I Gr AA R
кинорежиссёр	KJ I N O RJ E ZH Y S SJ OOh R
киностудинь	KJ I N O S T Uh DJ I NJ
кинофестиваль	KJ I N O FJ E S TJ I V A LJ
кинофильм	KJ I N O FJ I LJ M
кинофильмнүүд	KJ I N O FJ I LJ M N UUs T
кинофильмнүүдтэ	KJ I N O FJ I LJ M N UUs T T EH
кинофильмын	KJ I N O FJ I LJ M Y NG
кихот	KJ I H O T
класс	K L A S S
классай	K L A S S EE
классайнь	K L A S S EE NJ
классигуудай	K L A S SJ I Gr UUh D EE
классигуудые	K L A S SJ I Gr UUh D Y J EH
класста	K L A S S T EH
классуудта	K L A S S UUh T T EH
клуб	K L Uh P
клубые	K L Uh B Y J EH
км	K M
код	K O T
коллективтэй	K O L LJ E K TJ I F T EE
колхоз	K O L H O S
колхоздоо	K O L H O Z D OOh
колхозой	K O L H O Z EE
команда	K O M A N D EH
командын	K O M A N D Y NG
комиссиин	K O MJ I S SJ I NG
компьютер	K O M PJ J Uh TJ E R
компьютерна	K O M PJ J Uh TJ E R N EH
комсоргоор	K O M S EH R Gr OOh R
кондратьев	K O N D R A TJ J E F
кондратьевай	K O N D R A TJ J E V EE
концерт	K O N C E R T
концертын	K O N C E R T Y NG
корреспондент	K O R RJ E S P O N DJ E N T
космонавт	K O S M O N A F T
кофе	K O FJ EH
кофеһоо	K O FJ EH HH OOh
ксения	K SJ E NJ I J A
ксилитоол	K SJ I LJ I T O L
культпросвет	K Uh LJ T P R O S VJ E T
куполдо	K Uh P EH L D EH
курсда	K Uh R S D EH
курсые	K Uh R S Y J EH
лавренюк	L A V RJ E NJ Uh K
лагерь	L A GJ E RJ
лалын	L A L Y NG
лама	L A M EH
лангхау	L A N H A Uh
ланка	L A N K EH
лаос	L A O S
лариса	L A RJ I S A
лауреат	L A Uh RJ E A T
лебединое	LJ E BJ E DJ I N O J E
лекци	LJ E K C Y
ленинград	LJ E NJ I NG G R A T
ленточнэ	LJ E N T EH CH N EH
ленэ	LJ E N EH
литература	LJ I TJ E R A T Uh R EH
литератураар	LJ I TJ E R A T Uh R AA R
литературын	LJ I TJ E R A T Uh R Y NG
литр	LJ I T R
литрэй	LJ I T R EE
лицейинтернадай	LJ I C EE I N T E R N A D EE
лицейинтернадта	LJ I C EE I N T E R N A D T EH
лицейинтернадһаа	LJ I C EE I N T E R N A D HH AA
лопсон	L O P S EH NG
лочиновна	L O CH I N O V N A
лучший	L Uh CH SH Y J
лыгденов	L Y G DJ E N O F
лыгденовтэ	L Y G DJ E N O V T EE
лыгденовтэнэй	L Y G DJ E N O F T EH N EE
лыгденовэй	L Y G DJ E N O V EE
лэ	L EH
любви	LJ Uh B VJ I
маанадта	M AA N EH T T EH
маанараар	M AA N EH R AA R
маанарта	M AA N EH R T EH
маанарые	M AA N EH R Y J EH
маатти	M AA T TJ I
мааттида	M AA T TJ I D EH
магад	M A Gr EH D
магазин	M A Gr A ZJ I NG
магдан	M A G D EH NG
магданай	M A G D EH N EE
магна	M A NG EH
магтаа	M A K T AA
магтан	M A K T EH NG
магтанам	M A K T EH M EH M
майин	M EE J NG
майя	M A J A
мал	M A L
малаа	M A L AA
малай	M A L EE
малтай	M A L T EE
малша	M A L SH EH
малыеголы	M A L Y J EH G O L Y
манаа	M A N AA
манай	M A N EE
манайшье	M A N EE SH J EH
мандухаев	M A N D Uh H A J EH F
мария	M A RJ J A
мартаа	M A R T AA
мартаагүй	M A R T AA Gr UIs
мартаад	M A R T AA T
мартагдашагүй	M A R T EH G D EH SH EH Gr UIs
мартадаггүй	M A R T EH D EH G Gr UIs
мархаева	M A R H A J EH V A
мастер	M A S TJ E R
мастернуудые	M A S TJ E R N UUh D Y J EH
математика	M A TJ E M A TJ I K A
матикайнэн	M A TJ I K EE N E NG
матти	M A T TJ I
маттиин	M A T TJ I NG
маттинай	M A T TJ I N EE
махмуд	M A H M Uh T
машина	M A SH Y N EH
машинаар	M A SH Y N AA R
машинын	M A SH Y N Y NG
маяг	M A J A K
метр	MJ E T R
механизатораар	MJ E H A NJ I Z A T O R AA R
миин	MJ II NG
минжур	MJ N ZH UUh R
мини	MJ I NJ I
минии	MJ I NJ II
министерствын	MJ I NJ I S TJ E R S T V Y NG
минутын	MJ I N UUh T Y NG
миссия	MJ I S SJ I A
митрошкинатай	M I T R O SH KJ I N EH T EE
митупов	MJ I T Uh P O F
михеевич	MJ I HJ E J E VJ I CH
михей	MJ E HJ E J
михуулай	MJ I H UUh L EE
мишра	MJ I SH H EH
мм	M M
могол	M O Gr EH L
моголнуудай	M O Gr EH L N UUh D EE
могоолнуудай	M O Gr OOh L N UUh D EE
модо	M O D EH
модон	M O D EH NG
модоной	M O D EH N EE
мойһоор	M OE HH OOh R
мон	M O NG
монгол	M O NG Gr EH L
монголбуряадуудай	M O NG G EH L B Uh RJ AA D UUh D EE
монголой	M O NG G EH L EE
монголоо	M O NG G EH L OOh
монголшуудай	M O NG G EH L SH UUh D EE
монголһоо	M O NG G EH L HH OOh
мордоо	M O R D OOh
мордохом	M O R D EH H EH M
морин	M O RJ I NG
мориндо	M O RJ I N D EH
мориной	M O RJ I N EE
моринуудараа	M Uh RJ I N UUh D EH R AA
морихиро	M O RJ I HJ I R EH
морожено	M O R O ZH EH N EH
москва	M O S K V A
москвагай	M O S K V A Gr EE
москвадашье	M O S K V A D EH SH J EH
музей	M Uh ZJ EE
мундаргата	M Uh N D EH R Gr EH D EH
мундаргын	M Uh N D EH R Gr Y NG
мургаб	M Uh R Gr EH P
мусульман	M Uh S Uh LJ M A NG
муу	M UUh
муутай	M UUh T EE
муухайда	M UUh H EE D EH
мухаршэбэрэй	M Uh H EH R SH EH V EH R EE
мы	M Y
мэгдэншьегүй	M E G D EH N SH J EH Gr UIs
мэдэгдэжэ	M E D EH G D EH ZH EH
мэдэгма	M E D EH G M AA
мэдэдэг	M E D EH D EH K
мэдэдэггүй	M E D EH D EH G Gr UIs
мэдэжэ	M E D EH ZH EH
мэдэлдэ	M E D EH L D EH
мэдэн	M E D EH NG
мэдэнгүй	M E D EH NG G UIs
мэдэнэгүй	M E D EH N EH Gr UIs
мэдэрдэг	M E D EH R D EH K
мэдэржэ M E D EH R ZH EH
мэдэрнэ	M E D EH R N EH
мэдэрнэбди	M E D EH R N EH B DJ I
мэдэрэл	M E D EH R EH L
мэдэрэлээр	M E D EH R EH L EE R
мэдэсэеэ	M E D EH S EH J EE
мэдэхэ	M E D EH H EH
мэдэхэбибди	M E D EH H EH VJ I B DJ I
мэдэхэгүй	M E D EH H EH Gr UIs
мэдээд	M E D EE T
мэдээжэ	M E D EE ZH EH
мэдээсэл	M E D EE S EH L
мэдээсэлдэ	M E D EE S EH L D EH
мэдээсэлэй	M E D EE S EH L EE
мэдүүлбэ	M E D UUs L V EH
мэдүүлэл	M E D UUs L EH L
мэлс	M E L S
мэргэдэй	M E R Gr EH D EE
мэргэжэл	M E R Gr EH ZH EH L
мэргэжэлтэ	M E R Gr EH ZH EH L T EH
мэргэжэлтэд	M E R Gr EH ZH EH T T EH T
мэргэжэлтэй	M E R Gr EH ZH EH L T EE
мэргэжэлые	M E R Gr EH ZH EH L Y J EH
мэргэжэлэй	M E R Gr EH ZH EH L EE
мэргэжэлээрээ	M E R Gr EH ZH EH L EE R EE
мэргэн	M E R Gr EH NG
мэтэ	M E T EH
мэтэр	M E T EH R
мэтээр	M E T EE R
мэхэлэгдээд	M E H EH L EH G D EE T
мэхэлээгүй	M E H EH L EE Gr UIs
мэү	M E
мянга	MJ A NG G EH
мянгаад	MJ A NG G AA T
мянган	MJ A NG G EH NG
мяха	MJ A H EH
мүлижэ	M Us LJ I ZH EH
мүлиһэн	M Us LJ I HH EH NG
мүн	M Us NG
мүнгэ	M Us NG G EH
мүнгэн	M Us NG G EH NG
мүндэлһэн	M Us N D EH L HH EH NG
мүндэлөөд	M Us N D EH L OOs T
мүнхэ	M Us N H EH
мүнхэрөө	M Us N H EH R OOs
мүнэһэн	M Us N EH HH EH NG
мүнөө	M Us N OOs
мүнөөдэр	M Us N OOs D EH R
мүнөөдэрэй	M Us N OOs D EH R EE
мүнөөшье	M Us N OOs SH J EH
мүр	M Us R
мүргэдэг	M Us R Gr EH D EH K
мүргэл	M Us R Gr EH L
мүргэхэ	M Us R Gr EH H EH
мүрнүүд	M Us R N UUs T
мүрнүүдээрээ	M Us R N UUs D EE R EE
мүрнүүдһээ	M Us R N UUs D HH EE
мүртэй	M Us R T EE
мүрысэжэ	M Us R Y S EH ZH EH
мүрысөөн	M Us R Y S OOs NG
мүрэн	M Us R EH NG
мүрэнэй	M Us R EH N EE
мүрэнүүд	M Us R EH N UUs T
мүрөө	M Us R OOs
мүшэдэй	M Us SH EH D EE
мүүнөөдэр	M UUs N OOs D EH R
мүүрнүүд	M UUs R N UUs T
мүүрнүүдэй	M UUs R N UUs D EE
наада	N AA D EH
наадаар	N AA D AA R
наадан	N AA D EH NG
нааданай	N AA D EH N EE
нааданда	N AA D EH N D EH
наадаяа	N AA D EH J AA
наашаа	N AA SH AA
нагаса	N A Gr EH S EH
надежда	N A DJ E ZH D EH
нажарынь	N A ZH EH R Y NJ
найгалзаад	N EE Gr EH L Z AA T
найдал	N EE D EH L
найдамтай	N EE D EH M T EE
найман	N EE M EH NG
найрай	N EE R EE
найрлаа	N EE R L AA
найруулагша	N EE R UUh L EH G SH EH
найруулагшаар	N EE R UUh L EH G SH AA R
найруулагшын	N EE R UUh L EH G SH Y NG
найруулан	N EE R UUh L EH NG
намааршье	N A M AA R SH J EH
намайе	N A M EE J EH
намарай	N A M EH R EE
намда	N A M D EH
намжаа	N A M ZH AA
намжилма	N A M ZH Y L M A
намтарта	N A M T EH R T EH
намтаяа	N A M T A J AA
нангин	N A NG GJ I NG
нангинаар	N A NG GJ I N AA R
нанхяад	N A NG HJ AA T
нарай	N A R EE
наран	N A R EH NG
наранай	N A R EH N EE
нарин	N A RJ I NG
наринаар	N A RJ I N AA R
национальна	N A C Y O N A LJ N EH
наһа	N A HH EH
наһаараа	N A HH AA R AA
наһажаал	N A HH EH ZH AA L
наһан	N A HH EH NG
наһанай	N A HH EH N EE
наһанайм	N A HH EH N EE M
наһанайнгаа	N A HH EH N EE NG G AA
наһандаа	N A HH EH N D AA
наһандань	N A HH EH N D EH NJ
наһанһаа	N A HH EH N HH AA
наһанһаань	N A HH EH N HH AA NJ
наһатай	N A HH EH T EE
невыполнима	NJ E V Y P O L NJ I M EH
неделидэ	NJ E DJ E LJ I D EH
нива	NJ I V A
ниислэл	NJ II S L EH L
ниитын	NJ II T Y NG
ниитэ	NJ II T EH
николаевич	NJ I K O L A J E VJ I CH
нилээд	NJ I L EE T
нилээн	NJ I L EE NG
ногоон	N O Gr OOh NG
нойтон	N OE T EH NG
нойтотой	N OE T EH T EE
ном	N O M
номгон	N O M Gr EH NG
номдо	N O M D EH
номинацида	N O MJ I N A C Y D EH
номой	N O M EE
номууд	N O M UUh T
номуудай	N O M UUh D EE
номуудта	N O M UUh T T EH
номыень	N O M Y J EH NJ
нооһо	N OOh HH EH
норбоева	N O R B O J EH V A
нохой	N O H EE
ночь	N O CH
ноябрь	N O J A B RJ
ноёдто	N O J O D T EH
ноёхоной	N O J O H EH N EE
нугануудаар	N Uh Gr A N UUh D AA R
нуганууднай	N Uh Gr EH N UUh D EE
нугархай	N Uh Gr EH R H EE
нугархайгаар	N Uh Gr EH R H EE Gr AA R
нугархайень	N Uh Gr EH R H EH J EH NJ
нуур	N UUh R
нэбтэрүүлэгдэжэ	N E P T EH R UUs L EH G D EH ZH EH
нэбтэрүүлэгдэн	N E P T EH R UUs L EH G D EH NG
нэгые	N E Gr Y J EH
нэгэ	N E Gr EH
нэгэдэн	N E Gr EH D EH NG
нэгэдэхи	N E Gr EH D EH HJ I
нэгэдүүлхэ	N E Gr EH D UUs L H EH
нэгэдүүлэгдэһэн	N E Gr EH D UUs L EH G D EH HH EH NG
нэгэл	N E Gr EH L
нэгэмнай	N E Gr EH M N EE
нэгэн	N E Gr EH NG
нэгэнби N E Gr EH NG BJ I
нэгэндэ	N E Gr EH N D EH
нэгэниинь	N E Gr EH NJ II NJ
нэгэтэ	N E Gr EH T EH
нэгэшье	N E Gr EH SH J EH
нэмэжэ	N E M EH ZH EH
нэн	N E NG
нэрлээд	N E R L EE T
нэрлүүлжэ	N E R L UUs L ZH EH
нэрые	N E R Y J EH
нэрэ	N E R EH
нэрэеэ	N E R EH J EE
нэрэмжэтэ	N E R EH M ZH EH T EH
нэрэнэ	N E R EH N EH
нэрэтэй	N E R EH T EE
нэрэхэ	N E R EH H EH
нэрээ	N E R EE
нэха	N E H EH
нээгдээ	N EE G D EE
нээжэ	N EE ZH EH
нээрээшье	N EE R EE SH J EH
нээхэ	N EE H EH
нээхэдэ	N EE H EH D EH
нээхэдэнь	N EE H EH D EH NJ
нээһэн	N EE HH EH NG
нюдэндэ	NJ Uh D EH N D EH
нюдэниинь	NJ Uh D EH NJ II NJ
нюдэнсоошни	NJ Uh D EH N S OOh SH NJ I
нюрган	NJ Uh R Gr EH NG
нютаг	NJ Uh T EH K
нютагаа	NJ Uh T EH Gr AA
нютагаархидынь	NJ Uh T EH Gr AA R HJ I D Y NJ
нютагай	NJ Uh T EH Gr EE
нютагайнгаа	NJ Uh T EH Gr EE NG G AA
нютагайнь	NJ Uh T EH Gr EE NJ
нютагайхид	NJ Uh T EH Gr EE HJ I T
нютагайхидайнгаа	NJ Uh T EH Gr EE HJ I D EE NG G AA
нютагни	NJ Uh T EH G NJ I
нютагта	NJ Uh T EH K T EH
нютагтаа	NJ Uh T EH K T AA
нютагтай	NJ Uh T EH K T EE
нютагтамнай	NJ Uh T EH K T EH M N EE
нютагтань	NJ Uh T EH K T EH NJ
нютагууд	NJ Uh T EH Gr UUh T
нютагуудаар	NJ Uh T EH Gr UUh D AA R
нютагые	NJ Uh T EH Gr Y J EH
нютагһаа	NJ Uh T EH G HH AA
нюурта	NJ UUh R T EH
нюусануудаар	NJ Uh S EH N UUh D AA R
нягта	NJ A K T EH
нёдондо	NJ O D EH N D EH
нүгөө	N Us Gr OOs
нүлөө	N Us L OOs
нүлөөлэлгдэнэ	N Us L OOs L E L G D EH N EH
нүлөөлһэн	N Us L OOs L HH EH NG
нүхэд	N Us H EH T
нүхэдни	N Us H EH D NJ I
нүхэдынь	N Us H EH D Y NJ
нүхэр	N Us H EH R
нүхэртэ	N Us H EH R T EH
нүхэртэеэ	N Us H EH R T EH J EE
нүхэртэй	N Us H EH R T EE
нүхэрэй	N Us H EH R EE
нүхэрэйнгөө	N Us H EH R EE NG G OOs
нүхэсэлэй	N Us H EH S EH L EE
нүүдэлшэ	N UUs D EH L SH EH
нүүдэлшэдэй	N UUs D EH L SH EH D EE
обитаемый	O BJ I T A J E M Y J
обогууд	O V EH Gr UUh T
обоодоо	O V OOh D OOh
обёоржо	O VJ OOh R ZH EH
огто	O K T EH
одна	O D N EH
одо	O D EH
одоевич	O D O J E VJ I CH
одоо	O D OOh
одоол	O D OOh L
одхон	O T H EH NG
озеро	O ZJ EH R O
ой	OE
ойлгодогби	OE L Gr EH D EH G BJ I
ойлгое	OE L Gr EH J EH
ойлгожо	OE L Gr EH ZH EH
ойлгон	OE L Gr EH NG
ойлгоогүй	OE L Gr OOh Gr UIs
ойлгоходоо	OE L Gr EH H EH D OOh
ойлгуулжа	OE L Gr UUh L ZH EH
ойн	OE NG
ойрод	OE R EH T
окладников	O K L A D NJ I K O F
олдоно	O L D EH N EH
олдоногүй	O L D EH N EH Gr UIs
олдоогүй	O L D OOh Gr UIs
олдохо	O L D EH H EH
олзо	O L Z EH
олзын	O L Z Y NG
олимпиада	O LJ I M PJ I A D A
олимпиадада	O LJ I M PJ I A D EH D EH
олимпиаданууд	O LJ I M PJ I A D A D EH N UUh T
оло	O L EH
олодоггүйб  O L EH D EH G G UIs P
олой	O L EE
ололсожо	O L EH L S EH ZH EH
олон	O L EH NG
олонгоо	O L EH NG G OOh
олонгүй	O L EH NG G UIs
олондо	O L EH N D EH
олониие	O L EH NJ II J EH
олониитын	O L EH NJ II T Y NG
олонхи	O L EH N H I
олонхимнай	O L EH N HJ I M N EE
олоод	O L OOh T
олоор	O L OOh R
олоороо	O L OOh R OOh
олошорхо	O L EH SH EH R H EH
олоһоор	O L EH HH OOh R
ольга	O LJ G EH
ольтирогуудаар	O LJ TJ I R O Gr UUh D AA R
омар	O M EH R
омогорхол	O M EH Gr EH R H EH L
омогорхохоор    O M EH Gr EH R H EH H OOh R
он	O NG
ондо	O N D EH
ондоо	O N D OOh
оной	O N EE
онол	O N EH L
ономастика	O N EH M A S TJ I K A
онсо	O N S EH
онтохон	O N T EH H EH NG
онууд	O N UUh T
онуудта	O N UUh T T EH
онһоо	O N HH OOh
оперо	O PJ EH R EH
ордон	O R D EH NG
ордонтой	O R D EH N T EE
ореолто	O RJ O L T EH
ореолтонуудай	O RJ OOh L T EH N UUh D EE
ори	O RJ I
орилхыень	O RJ I L H Y J EH NJ
оробо	O R O V EH
ород	O R EH T
орожо	O R O ZH EH
орой	O R EE
оройгдооб	O R EE G D OOh P
оройдоо	O R EE D OOh
оройдоол	O R EE D OOh L
оройе	O R EE J EH
оройнууд	O R EE N UUh T
оролдодог	O R EH L D EH D EH K
оролдодогби	O R EH L D EH D EH G BJ I
оролдожол	O R EH L D EH ZH EH L
оролдолго	O R EH L D EH L Gr EH
оролдолгоор	O R EH L D EH L Gr OOh R
оролдоо	O R EH L D OOh
оролсоно	O R EH L S EH N EH
орон	O R EH NG
орондо	O R EH N D EH
орондоо	O R EH N D OOh
ороной	O R EH N EE
ороноймнай	O R EH N EE M N EE
оронойнгоо	O R EH N OE NG G OOh
ороноор	O R EH N OOh R
оронхой	O R EH N H EE
ороо	O R OOh
орооб	O R OOh P
ороод	O R OOh T
орохо	O R O H EH
орохоб	O R O H EH P
орохобди	O R O H EH B DJ I
ороходоо	O R O H EH D OOh
орохыень	O R O H Y J EH NJ
ороһон	O R EH HH EH NG
ороһоор	O R EH HH OOh R
оруулагдана	O R UUh L EH G D EH N EH
оруулбал	O R UUh L V EH L
оруулдаг	O R UUh L D EH K
оруулжа	O R UUh L ZH EH
орхеоб	O R HJ OOh P
орхигдоһон	O R HJ I G D EH HH EH NG
оршодог	O R SH EH D EH K
оршом	O R SH EH M
оршоһон	O R SH EH HH EH NG
оршуулагша	O R SH UUh L EH G SH EH
орёо	O RJ OOh
орёохон	O RJ OOh H EH NG
остров	O S T R O F
отделенидэ	O T DJ EH LJ EH NJ I D EH
оулуһаань	O Uh L Uh HH AA NJ
охин	O HJ I NG
охрын	O R H Y NG
очно	O CH N EH
ошобобди	O SH EH V EH B DJ I
ошодог	O SH EH D EH K
ошодоггүй	O SH EH D EH G Gr UIs
ошожо	O SH EH ZH EH
ошолго	O SH EH L Gr EH
ошон	O SH EH NG
ошоноб	O SH EH N EH P
ошоо	O SH OOh
ошоогүй	O SH OOh Gr UIs
ошохо	O SH EH H EH
ошохоб	O SH EH H EH P
ошоходоо	O SH EH H EH D OOh
ошоходош	O SH EH H EH D EH SH
ошоһон	O SH EH HH EH NG
оюна	O J Uh N EH
оюун	O J UUh NG
оюутад	O J UUh T EH T
оюутан	O J UUh T EH NG
оёорто	O J OOh R T EH
павел	P A VJ EH L
пакистан	P A KJ I S T A NG
парти	P A R TJ I
пашту	P A SH T Uh
пеккин	P E KJ I NG
пеккинэй	PJ E KJ I N EE
пеккэ	PJ E K K E
пенсидэ	PJ E N SJ I D EH
печени	PJ E CH E NJ I
писаницы	PJ I S A NJ I C Y
питер	PJ I TJ E R
пластик	P L A S TJ I K
платитай	P L A TJ I T EE
поездруу	P O J E Z D R UUh
полис	P O LJ I S
полисоо	P O LJ I S OOh
полнометражный	P O L N EH MJ EH T R A ZH N Y J
португал	P O R T Uh Gr A L
почтальоноор	P O CH T A LJ O N OOh R
почтыень	P O CH T Y J EH NJ
поэдүүд	P O E D UUs T
поэзии	P O E ZJ II
поэзиин	P O E ZJ II NG
поэт	P O E T
правин	P R A VJ I NG
практикада	P R A K TJ I K EH D EH
премьерын	P RJ E MJ J EH R Y NG
премьерэ	P RJ E MJ J EH R EH
премьерээр	P RJ E MJ J EH R EE R
программа	P R O G R A M M EH
программаар	P R O G R A M M AA R
программада	P R O G R A M M EH D EH
программар	P R O G R A M M A R
продюсер	P R O DJ Uh SJ E R
проект	P R O J EH K T
проектнүүдые	P R O J EH K T N UUh D Y J EH
проектые	P R O J EH K T Y J EH
проектын	P R O J EH K T Y NG
протасоватай	P R O T A S O V A T EE
профессор	P R O FJ E S S EH R
путкинооткэ	P Uh T KJ I N OOh T K EH
путкинотко	P Uh T KJ I N O T K O
пушкин	P Uh SH KJ I NG
пүмпөөдэһөөнь	P Us M P OOs D EH HH OOs NJ
раднаев	R A D N A J EH F
раднаева	R A D N A J EH V A
раднажап	R A D N A ZH EH P
раиса	R A I S A
районогой	R A J OOh N EH Gr EE
ракшаева	R A K SH A J E V A
раскадровщигоор	R A S K A D R O F SCH I Gr OOh R
режима	RJ E ZH Y M EH
режиссёр	RJ E ZH Y S SJ OOh R
режиссёрнуудтай	RJ E ZH Y S SJ OOh R N UUh T T EE
режиссёрой	RJ E ZH Y S SJ OOh R EE
рекламна	RJ E K L A M N EH
репетиторнүүд	RJ E PJ E TJ I T O R N UUh T
республика	RJ E S P Uh B LJ I K EH
республикымнай	RJ E S P Uh B LJ I K Y M N EE
республикын	RJ E S P Uh B LJ I K Y NG
ринчинович	RJ I N CH I N O VJ I CH
ринчиновичэй	RJ I N CH I N O VJ I CH EE
ринчиногой	RJ I N CH I N O Gr EE
родионовна	R O DJ I O N O V N A
роза	R O Z EH
ролигуудые	R O LJ I Gr UUh D Y J EH
роман	R O M A NG
росси	R O S SJ I
россиин	R O S SJ II NG
руу	R UUh
саада	S AA D EH
саана	S AA N EH
саашаа	S AA SH AA
саашадаа	S AA SH EH D AA
саашань	S AA SH EH NJ
сабшалга	S A P SH EH L Gr EH
саг	S A K
сагаалганай	S A Gr AA L Gr EH N EE
сагаан	S A Gr AA NG
сагай	S A Gr EE
сагаймни	S A Gr EE M NJ I
сагдаанар	S A G D AA N EH R
сагни	S A G NJ I
сагта	S A G T EH
сагһаа	S A G HH AA
садхалан	S A D H EH L EH NG
сай	S EE
сайлуулжа	S EE L UUh L ZH EH
сайт	S EE T
сакья	S A KJ J AA
санагын	S A N EH Gr Y NG
санда	S A N D EH
санданов	S A N D A N O V
санжа	S A N ZH EH
санжиевна	S A N ZH Y J EH V N A
санжимитупов	S A N ZH Y MJ I T Uh P O F
сара	S A R EH
сараа	S A R AA
сарьдаг	S A RJ D EH K
сарюун	S A RJ UUh NG
сахаяхадай	S A H A J EH H EH D EE
сахижа	S A HJ I ZH EH
сахихаяа	S A HJ I H EH J AA
сая	S A J A
саяан	S A J AA NG
саяанайм	S A J AA N EE M
саян	S A J A NG
саһанай	S A HH EH N EE
светлана	S VJ E T L A N EH
секретаревич	SJ E K RJ E T A RJ E VJ I CH
секундын	SJ E K Uh N D Y NG
секцидэ	SJ E K C Y D EH
семеновой	SJ E MJ O N O V EE
сентябриин	SJ E N TJ A B RJ II NG
сибириин	SJ I BJ I RJ II NG
сибирь	SJ I BJ I RJ
сиддарта	SJ I D D A R T EH
сингапур	SJ I N G A P Uh R
сингх	SJ I N K H
смигэй	S MJ I Gr EE
совет	S O VJ E T
советскэ	S O VJ E T S K EH
совхозой	S O F H O Z EE
совхозуудай	S O F H O Z UUh D EE
согтохангил	S O K T EH H A N GJ I L
солбон	S O L V EH NG
солист	S O LJ I S T
солонгос	S O L EH NG G EH S
солотой	S O L EH T EE
сонгоол	S O NG G OOh L
сонимнай	S O NJ I M N EE
сониндо	S O NJ I N D EH
сониной	S O NJ I N EE
соностохо	S O N EH S T EH H EH
соносхолнууд	S O N EH S H EH L N UUh T
сонхоной	S O N H EH N EE
сонхонуудые	S O N H EH N UUh D Y J EH
сонхоор	S O N H OOh R
сонхын	S O N H Y NG
сонь	S O NJ
соо	S OOh
соогоо	S OOh Gr OOh
соогуур	S OOh Gr UUh R
соомнай	S OOh M N EE
соонь	S OOh NJ
соошоогоо	S OOh SH OOh Gr OOh
соошье	S OOh SH J EH
сооһоонь	S OOh HH OOh NJ
соробхилно	S O R EH F HJ I L N EH
сохи	S O HJ I
сохилго	S O HJ I L Gr EH
сохом	S O H EH M
сошоолгоо	S O SH OOh L Gr OOh
союзай	S O J Uh Z EE
соёл	S O J O L
соёлдо	S O J O L D EH
соёлма	S O J O L M A
соёлнуудай	S O J O L N UUh D EE
соёлой	S O J O L EE
соёлоор	S O J O L OOh R
соёлтой	S O J O L T EE
спорт	S P O R T
спортдо	S P O R T D EH
спортын	S P O R T Y NG
сссрэй	S S S R EE
степанович	S TJ E P A N O VJ I CH
строгого	S T R O Gr O Gr EH
студи	S T Uh DJ I
субарга	S Uh V EH R Gr EH
субаһан	S Uh V EH HH EH NG
суг	S Uh K
суглаанда	S Uh G L AA N D EH
суглуулагдамал	S Uh G L UUh L EH G D EH M EH L
суглуулагдана	S Uh G L UUh L EH G D EH N EH
суглуулагдаһан	S Uh G L UUh L EH G D EH HH EH NG
суглуулбари	S Uh G L UUh L V EH RJ I
суглуулдаг	S Uh G L UUh L D EH K
суглуулжа	S Uh G L UUh L ZH EH
сультимова	S Uh LJ TJ I M O V A
сурбалжалагша	S Uh R V EH L ZH EH L EH K SH EH
сурбалжалагшатай	S Uh R V EH L ZH EH L EH K SH EH T EE
суулга	S UUh L Gr EH
суулгада	S UUh L Gr EH D EH
суулгаһаа	S UUh L Gr EH HH AA
суулгын	S UUh L Gr Y NG
суурхадаг	S UUh R H EH D EH K
сууряан	S UUh RJ AA NG
суута	S UUh T EH
суутай	S UUh T EE
сухалдуулаа	S Uh H EH L D UUh L AA
сухарихагүй	S Uh H EH RJ I H EH Gr UIs
сшагай	S SH A Gr EE
сэбэр	S E V EH R
сэбэрлэлгэ	S E V EH R L EH L Gr EH
сэбэрлэлтэ	S E V EH R L EH L T EH
сэгнэдэг	S E G N EH D EH K
сэгнэлтэ	S E G N EH L T EH
сэгнэлтэдэ	S E G N EH L T EH D EH
сэгнэлтэнүүдые	S E G N EH L T EH N UUs D Y J EH
сэдьхэл	S E DJ H EH L
сэдьхэлдэ	S E TJ H EH L D EH
сэдьхэлдэм	S E TJ H EH L D EH M
сэдьхэлдээ	S E TJ H EH L D EE
сэдьхэлни	S E TJ H EH L NJ I
сэдьхэлтэй	S E TJ H EH L T EE
сэдьхэлшни	S E TJ H EH L SH NJ I
сэдьхэлэй	S E TJ H EH L EE
сэдьхэлэйнгээ	S E TJ H EH L EE NG G EE
сэдьхэлээ	S E TJ H EH L EE
сэдьхэлээрээ	S E TJ H EH L EE R EE
сэлэнгын	S E L EH NG G Y NG
сэнтэй	S E N T EE
сэнтэйб	S E N T EE P
сэрэгшэн	S E R EH K SH EH NG
сэрэгэй	S E R EH Gr EE
сэсэг	S E S EH G
сэсэгые	S E S EH Gr Y J EH
сэсэгэй	S E S EH Gr EE
сэсэгүүдэй	S E S EH Gr UUs D EE
сэсэн	S E S EH NG
сэсэрлиг	S E S EH R LJ I K
сэсэрлигтэ	S E S EH R LJ I K T EH
сэхыень	S E H Y J EH NJ
сэхынь	S E H Y NJ
сэхэ	S E H EH
сүлдэ	S Us L D EH
сүлэй	S Us L EE
сүлөө	S Us L OOs
сүлөөгүй	S Us L OOs Gr UIs
сүлөөтэйгөөр	S Us L OOs T EE Gr OOs R
сүм	S Us M
та	T A
таабайн	T AA V EE NG
таалаха	T AA L EH H EH
тааруу	T AA R UUh
тааруулжа	T AA R UUh L ZH EH
таба	T A V EH
табан	T A V EH NG
табанай	T A V EH N EE
табибагүй	T A VJ I V EH Gr UIs
табигдаа	T A VJ I G D AA
табигданхай	T A VJ I G D EH N H EE
табигдаһаан	T A VJ I G D EH HH AA NG
табигдаһан	T A VJ I G D EH HH EH NG
табигшад	T A VJ I K SH EH T
табидаг	T A VJ I D EH K
табижа	T A VJ I ZH EH
табилсаа	T A VJ I L S AA
табимаар	T A VJ I M AA R
табиха	T A VJ I H EH
табихаш	T A VJ I H EH SH
табихаһаа	T A VJ I H EH HH AA
табиһан	T A VJ I HH EH NG
табяа	T A VJ AA
таисия	T A I SJ I J A
тайвань	T A J V A NJ
тайзан	T EE Z EH NG
тайланд	T A J L A N D
тайлбарилаатай	T EE L V EH RJ I L AA T EE
тайлбарилха	T EE L V EH RJ I L H EH
тайлга	T EE L Gr EH
тайлган	T EE L Gr EH NG
тайна	T EE N EH
тала	T A L EH
талаан	T A L AA NG
талаангаа	T A L AA NG G AA
талааниинь	T A L AA NJ II NJ
талаантай	T A L AA N T EE
талаар	T A L AA R
талаараа	T A L AA R AA
таладань	T A L EH D EH NJ
талаһаа	T A L EH HH AA
талаһаань	T A L EH HH AA NJ
талисман	T A LJ I S M A NG
талмайн	T A L M EE NG
талхатай	T A L H EH T EE
талые	T A L Y J EH
талын	T A L Y NG
тамирай	T A MJ I R EE
таммиинэн	T A M MJ II N E NG
тамминэн	T A M MJ I N E NG
тамминэни	T A M MJ I N E NJ I
танай	T A N EE
тангадай	T A NG G EH D EE
тангатовна	T A NG G A T O V N A
тангатовнагай	T A NG G A T O V N A Gr EE
танда	T A N D EH
таниие	T A NJ I J EH
танил	T A NJ I L
танилсаа	T A NJ I L S AA
танилсаабди	T A NJ I L S AA B DJ I
танилсаад	T A NJ I L S AA T
танилсалга	T A NJ I L S EH L Gr EH
танилсаха	T A NJ I L S EH H EH
танилсаһан	T A NJ I L S EH HH EH NG
танилсуулаа	T A NJ I L S UUh L AA
танилсуулха	T A NJ I L S UUh L H EH
танхим	T A N HJ I M
тараадаг	T A R AA D EH K
тарааха	T A R AA H EH
тараашад	T A R AA SH EH T
тараашадбди	T A R AA SH EH D B DJ I
тараһан	T A R EH HH EH NG
тарбагатайская	T A R B A G A T A J S K A J A
тарган	T A R Gr EH NG
тартай	T A R T EE
таряалан	T A RJ AA L EH NG
таряаша	T A RJ AA SH EH
татаа	T A T AA
татаарнууд	T A T AA R N UUh T
татаатай	T A T AA T EE
татааш	T A T AA SH
татагдадаг	T A T EH G D EH D EH K
татан	T A T EH NG
татана	T A T EH N EH
татаса	T A T EH S EH
татаһан	T A T EH HH EH NG
татуулаа	T A T UUh L AA
татьяна	T A TJ J A N A
ташаба	T A SH EH V EH
ташажал	T A SH EH ZH EH L
ташалгаар	T A SH EH L Gr AA R
ташалганда	T A SH EH L Gr EH N D EH
ташуурдуулааб	T A SH UUh R D UUh L AA P
таһаг	T A HH EH K
таһагай	T A HH EH Gr EE
таһагта	T A HH EH G T EH
таһалга	T A HH EH L Gr EH
таһалгада	T A HH EH L Gr EH D EH
таһалхагүйн	T A HH EH L H EH Gr UIs NG
таһалһан	T A HH EH L HH EH NG
таһараа	T A HH AA R AA
таһараагүй	T A HH EH R AA Gr UIs
театр	TJ E A T R
театрай	TJ E A T R EE
театрайнгаа	TJ E A T R EE NG G AA
театрайхид	TJ E A T R EE HJ I T
театральна	TJ E A T R A LJ N EH
театрнуудай	TJ E A T R N UUh D EE
температура	TJ E M PJ E R A T Uh R A
теравада	TJ E R A V A D A
терапи	TJ E R A PJ I
технологическа	TJ E H N O L O GJ I CH EH S K EH
теэд	TJ EE T
тиигэбэл	TJ II Gr EH V EH L
тиигэбэшье	TJ II Gr EH V EH SH J EH
тиигэжэ	TJ II Gr EH ZH EH
тиигээд	TJ II Gr EE T
тиигээдшье	TJ II Gr EE D SH Y J EH
тиигэһээр	TJ II Gr EH HH EE R
тиимэ	TJ II M EH
тиимэл	TJ II M EH L
тиимэшиимэш	TJ II M EH SH J M EH SH
тиимэшье	TJ II M EH SH J EH
тиимэһээ	TJ II M EH HH EE
тиин	TJ II NG
тиихэ	T II H EH
тиихэдэ	TJ II H EH D EE
тиихэдэнь	TJ II H EH D EH NJ
тиихэдээ	TJ II H EH D EE
тиишэ	TJ II SH EH
тиишээ	TJ II SH EE
тимофей	TJ I M O FJ E J
тимур	TJ I M Uh R
тобир	T O VJ I R
тогооной	T O Gr OOh N EE
тогоошон	T O Gr OOh SH EH NG
тогтоол	T O K T OOh L
тогтоохо	T O K T OOh H EH
тогтохоевна	T O K T EH H O J EH V N A
тогтошонгүй	T O K T EH SH EH N G UIs
тогтоһон	T O K T EH HH EH NG
тодорбо	T O D EH R V EH
тойрогой	T OE R EH Gr EE
тойрогоор	T OE R EH Gr OOh R
тойрогто	T OE R EH K T EH
тойроод	T OE R OOh T
толгойгоо	T O L Gr EE Gr OOh
толгойгороо	T O L Gr EE Gr O R OOh R
толи	T O LJ I
толстой	T O L S T O J
томо	T O M EH
томорхуу	T O M EH R H UUh
томохон	T O M EH H EH NG
томошуул	T O M SH UUh L
тон	T O NG
тоо	T OOh
тоогдонгүй	T OOh G D EH NG G UIs
тоогоор	T OOh Gr OOh R
тоодо	T OOh D EH
тоологдодог	T OOh L EH G D EH D EH K
тоонто	T OOh N T EH
тоонтотой	T OOh N T EH T EE
тоонтоёо	T OOh N T EH J OOh
тооһо	T OOh HH EH
тооһоноо	T OOh HH EH N OOh
тордиһогүй	T O R DJ I HH EH Gr UIs
тохожорхихо	T O H EH ZH E R HJ I H EH
тохёолдожо	T O HJ OOh L D EH ZH EH
тохёолдоод	T O HJ OOh L D OOh T
тоһо	T O HH EH
тоһон	T O HH EH NG
травоолтэ	T R A V OOh L T EH
трактаар	T R A K T AA R
трактортай	T R A K T EH R T EE
тренер	T RJ E NJ E R
тренерэйнь	T RJ E NJ E R EE NJ
трюгүүдые	T RJ UUh Gr UUs D Y J EH
тугал	T Uh Gr EH L
тудалдадаг	T Uh D EH L D EH D EH K
тудашоо	T Uh D EH SH OOh
туйлалта	T UIs L EH L T EH
туйлаһан	T UIh L EH HH EH NG
тула	T Uh L EH
тулада	T Uh L EH D EH
тулалдаанай	T Uh L EH L D AA N EE
туласа	T Uh L EH S EH
тунгалаг	T Uh NG G EH L EH K
тунгус	T Uh NG G Uh S
тура	T Uh R EH
туркада	T Uh R K EH D EH
туркуһаань	T Uh R K Uh HH AA NJ
турша	T Uh R SH EH
туршагты	T Uh R SH EH K T Y
туршада	T Uh R SH EH D EH
туршажа	T Uh R SH EH ZH EH
туршаха	T Uh R SH EH H EH
тус	T Uh S
тусда	T Uh S D EH
тухай	T Uh H EE
тухайгаа	T Uh H EE Gr AA
тухайм	T Uh H EE M
туяа	T Uh J AA
туһа	T Uh HH EH
туһаар	T Uh HH AA R
туһалалсаа	T Uh HH EH L EH L S AA
туһаламжа	T Uh HH EH L EH M ZH EH
туһаламжанууд	T Uh HH EH L EH M ZH EH N UUh T
туһалдаг	T Uh HH EH L D EH K
туһалжа	T Uh HH EH L ZH EH
туһалсажа	T Uh HH EH L S EH ZH EH
туһалха	T Uh HH EH L H EH
туһалхые	T Uh HH EH L H Y J EH
туһатай	T Uh HH EH T EE
туһаяа	T Uh HH EH J AA
тысяча	T Y SJ A CH A
тэбэрихэ	T E V EH RJ I H EH
тэгшэ	T E K SH EH
тэдхэмжэ	T E T H EH M ZH EH
тэдэ	T E D EH
тэдэмнай	T E D EH M N EE
тэдэнэй	T E D EH N EE
тэдэнэйнь	T E D EH N EE NJ
тэдэнэр	T E D EH N EH R
тэдэнэрэй	T E D EH N EH R EE
тэдэнээ	T E D EH N EE
тэдээндэ	T E D EE N D EH
тэдээнтэй	T E D EE N T EE
тэжээ	T E ZH EE
тэжээгты	T E ZH EE K T Y
тэжээхэ	T E ZH EE H EH
тэжээхэеэ	T E ZH EE H EH J EE
тэмдэглэдэг	T E M D EH G L EH D EH K
тэмдэглэмээр	T E M D EH G L EH M EE R
тэмдэглээ	T E M D EH G L EE
тэмдэглэһээр	T E M D EH G L EH HH EE R
тэмсээн	T E M S EE NG
тэнгисэй	T E NG GJ I S EE
тэнгэриин	T E NG G EH RJ II NG
тэндэ	T E N D EH
тэндэмни	T E N D EH M NJ I
тэндэнь	T E N D EH NJ
тэндэхи	T E N D EH HJ I
тэниидэг	T E NJ II D EH K
тэнюун	T E NJ UUh NG
тэригүүн	T E RJ I Gr UUs NG
тэрлигээ    T E R LJ I Gr EE
тэрьедээд	T E RJ J E D EE T
тэрэ	T E R EH
тэрэмни	T E R EH M NJ I
тэрэниие	T E R EH NJ II J EH
тэрэнтэй	T E R EH N T EE
тэрэнэй	T E R EH N EE
тэрэнээ	T E R EH N EE
тэрэшни	T E R EH SH NJ I
тэрээн	T E R EE NG
тэрээндэ	T E R EE N D EH
тэрээндэнь	T E R EE N D EH NJ
тэрээниие	T E R EE NJ II J EH
тэрээнһээ	T EH R EE N HH EE
тэрээхэнэй	T E R EE H EH N EE
тэсэмгэй	T E S EH M Gr EE
тээ	T EE
тээшэ	T EE SH EH
түб	T Us P
түби	T Us VJ I
түбхинэһэн	T Us P HJ I N EH HH EH NG
түбхинөө	T Us P HJ I N OOs
түбэй	T Us V EE
түбүүдһээ	T Us V UUs D HH EE
түгнын	T Us G N Y NG
түгнынгөө	T Us G N Y NG G OOs
түгэлдэр	T Us Gr EH L D EH R
түгэсхэлэй	T Us Gr EH S H EH L EE
түгэсэбэ	T Us Gr EH S EH V EH
түлбэри	T Us L V EH RJ I
түлеэ	T Us LJ EE
түлхюур	T Us L HJ UUh R
түлөө	T Us L OOs
түлөөлэгшэд	T Us L OOs L EH K SH EH T
түлөөһэгүйгөөр	T Us L OOs HH EH Gr UIs Gr OOs R
түмэр	T Us M EH R
түмүрид	T Us M Us RJ I T
түнхэн	T Us N H EH NG
түнхэнэй	T Us N H EH N EE
түргэ	T Us R Gr EH
түргэн	T Us R Gr EH NG
түргэнөөр	T Us R Gr EH N OOs R
түргэхэнөөр	T Us R Gr EH H EH N OOs R
түрхидэг	T Us R HJ I D EH K
түрын	T Us R Y NG
түрэ	T Us R EH
түрэл	T Us R EH L
түрэлнүүд	T Us R EH L N UUh T
түрэлхид	T Us R EH L HJ I D
түрэлхидтэеэ	T Us R EH L HJ I T T E J EE
түрэхэһөө	T Us R EH H EH HH OOs
түрэһэн	T Us R EH HH EH NG
түрэһэнэй	T Us R EH HH EH N EE
түрүү	T Us R UUs
түрүүл	T Us R UUs L
түрүүлжэ	T Us R UUs L ZH EH
түрүүлнэ	T Us R UUs L N EH
түрүүлэгшэ	T Us R UUs L EH K SH EH
түрүүн	T Us R UUs NG
түрүүтэй	T Us R UUs T EE
түрүүшын	T Us R UUs SH Y NG
түрүүшынхеэ	T Us R UUs SH Y N HJ EE
түрүүшынхиеэ	T Us R UUs SH Y N HJ I J EE
түрүүшээр	T Us R UUs SH EE R
түрүүшүүлэй	T Us R UUs SH UUs L EE
түрөө	T Us R OOs
түсэб	T Us S EH P
түсэбүүд	T Us S EH V UUs T
түхэл	T Us H EH L
түхэлөөр	T Us H EH L OOs R
түхэм	T Us H EH M
түхөөбэ	T Us H OOs B EH
түүлөөбди	T UUs L OOs B DJ I
түүхэ	T UUs H EH
түүхэдэ	T UUs H EH D EE
түүхэй	T UUs H EE
түүхэтэ	T UUs H EH T EH
түүхэтэй	T UUs H EH T EE
убушеевичай	Uh V Uh SH E J E VJ I CH EE
уг	Uh K
угаа	Uh Gr AA
угаараа	Uh Gr AA R AA
угай	Uh Gr EE
угайм	Uh Gr EE M
угтагдаа	Uh K T EH G D AA
угтагдажа	Uh K T EH G D EH ZH EH
угтадаг	Uh K T EH D EH K
угтажа	Uh T K EH ZH EH
угтан	Uh K T EH NG
угтахань	Uh K T EH H EH NJ
угтаһан	Uh K T EH HH EH NG
угуудай	Uh Gr UUh D EE
угһаа	Uh G HH AA
удаа	Uh D AA
удаан	Uh D AA NG
удаань	Uh D AA NJ
удаахан	Uh D AA H EH NG
удаганай	Uh D EH Gr EH N EE
уданшьегүй	Uh D EH NG SH J EH Gr UIs
ударидалгатай	Uh D EH RJ I D EH L Gr EH T EE
удахагүй	Uh D EH H EH Gr UIs
удха	Uh T H EH
удхатай	Uh T H EH T EE
уйгуурнууд	UIh Gr UUh R N UUh T
уйлана	UIh L EH N EH
улаан	Uh L AA NG
улаанбаатарай   Uh L AA NG B AA T EH R EE
улаанүдын	Uh L AA N Us D Y NG
улаанүдэ	Uh L AA N Us D EH
улаанүдэдэ	Uh L AA N Us D EH D EH
уладууд	Uh L EH D UUh T
улам	Uh L EH M
улан	Uh L EH NG
уларилтай	Uh L EH RJ I L T EE
улас	Uh L EH S
уласай	Uh L EH S EE
уласта	Uh L EH S T EH
уласуудта	Uh L EH S UUh T T EH
уласхоорондын	Uh L EH S H OOh R EH N D Y NG
уласые	Uh L EH S Y J EH
унаган	Uh N EH Gr EH NG
уналга	Uh N EH L Gr EH
унахадань	Uh N EH H EH D EH NJ
ундалжа	Uh N D EH L ZH EH
университедэй	Uh NJ I VJ E R SJ I TJ E D EE
университет	Uh NJ I VJ E R SJ I TJ E T
унталгын	Uh N T EH L Gr Y NG
уншааб	Uh N SH AA P
уншаад	Uh N SH AA T
уншагшадай	Uh N SH EH K SH EH D EE
уншагшадтаа	Uh N SH EH K SH EH T T AA
уншагшадтаяа	Uh N SH EH K SH EH T T EH J AA
уншагшадые	Uh N SH EH K SH EH D Y J EH
уншадаг	Uh N SH EH D EH K
уншана	Uh N SH EH N EH
уншаха	Uh N SH EH H EH
уншаһан	Uh N SH EH HH EH NG
урагшаа	Uh R EH G SH AA
урагшань	Uh R EH K SH EH NJ
урагшатай	Uh R EH G SH EH T EE
уран	Uh R EH NG
уранаар	Uh R EH N AA R
урбашагүй	Uh R V EH SH EH Gr UIs
ургалта	Uh R Gr EH L T EH
ургамал	Uh R Gr EH M EH L
урган	Uh R Gr EH NG
ургы	Uh R Gr Y
ургыхан	Uh R Gr Y H EH NG
урда	Uh R D EH
урдаа	Uh R D AA
урданай	Uh R D EH N EE
урданайнгаа	Uh R D EH N EE NG G AA
урдуулаагүй	Uh R D UUh L AA Gr UIs
урдын	Uh R D Y NG
урид	Uh RJ I T
уридаг	Uh RJ I D EH K
урижа	Uh RJ I ZH EH
урин	Uh RJ I NG
урихадань	Uh RJ I H EH D EH NJ
урихан	Uh RJ I H EH NG
уриһан	Uh RJ I HH EH NG
урматай	Uh R M EH T EE
уряа	Uh RJ AA
уряална	Uh RJ AA L N EH
усалталгада	Uh S EH L T EH L Gr EH D EH
устьордада	Uh S TJ O R D A D EH
устьордын	Uh S TJ O R D Y NG
ута	Uh T EH
утаһаар	Uh T A HH AA R
утаһые	Uh T A HH Y J EH
уужа	UUh ZH EH
уужамаар	UUh ZH EH M AA R
уула	UUh L EH
уулада	UUh L EH D EH
уулархаг	UUh L EH R H EH K
уулаяа	UUh L A J AA
уулаһаашье	UUh L EH HH AA SH J EH
уулзаа	UUh L Z AA
уулзажа	UUh L Z EH ZH EH
уулзалга	UUh L Z EH L Gr EH
уулзахадаа	UUh L Z EH H EH D AA
уулзаһан	UUh L Z EH HH EH NG
уулын	UUh L Y NG
ухаагаараа	Uh H AA Gr AA R AA
ухаан	Uh H AA NG
ухаанай	Uh H AA N EE
ухаандаа	Uh H AA N D AA
ухаантай	Uh H AA N T EE
ухаатай	Uh H AA T EE
училищи	Uh CH I LJ I SCH I
училищида	Uh CH I LJ I SCH I D EH
училищиин	Uh CH I LJ I SCH I NG
училищияа	Uh CH I LJ I SCH I J AA
ушар	Uh SH EH R
ушаралай	Uh SH EH R EH L EE
ушарнууд	Uh SH EH R N UUh T
ушарнуудаар	Uh SH EH R N UUh D AA R
ушарнуудтай	Uh SH EH R N UUh T T EE
ушартаа	Uh SH EH R T AA
уялга	Uh J EH L Gr EH
уялгалха	Uh J EH L Gr EH L H EH
уялгата	Uh J EH L Gr EH T EH
уян	Uh J A NG
уянгатайгаар	Uh J A NG Gr EH T EE Gr AA R
уянгые	Uh J A NG G Y J EH
уяруулна	Uh J A R UUh L N EH
уһа	Uh HH EH
уһан	Uh HH EH NG
уһанайнь	Uh HH EH N EE NJ
уһанда	Uh HH EH N D EH
уһатай	Uh HH EH T EE
факультативна	F A K Uh LJ T A TJ I V N EH
факультедтэ	F A K Uh LJ TJ EH T T EH
фермернүүд	FJ E R MJ EH R N UUs T
фермернүүдтэ	FJ E R MJ EH R N UUs T T EH
фестивалиин	FJ E S TJ I V A LJ II NG
фестивальнуудта	FJ E S TJ I V A LJ N UUh T T EH
физическэ	FJ I ZJ I CH E S K EH
философско	FJ I L O S O F S K EH
фильм	FJ I LJ M
фильмнүүдые	FJ I LJ M N UUs D Y J EH
финляндиин	FJ I N LJ A N DJ II NG
флодой	F L O D EE
фм	EH F EH M
фольклорно	F O LJ K LJ O R N EH
фонтан	F O N T A NG
фото	F O T EH
францида	F R A N C Y D EH
франциин	P R A N C Y NG
француз	F R A N C Us S
ха	H A
хаагаа	H AA Gr AA
хаагданхай	H AA G D EH N H EE
хаажа	H AA ZH EH
хаан	H AA NG
хаана	H AA N EH
хаанабииб	H AA N EH VJ II P
хаанабши	H AA N EH P SH Y
хаанай	H AA N EE
хаанахи	H AA N EH HJ I
хаанашье	H AA N EH SH J EH
хаанаһаа	H AA N EH HH AA
хаашаг	H AA SH EH K
хаашагай	H AA SH EH Gr EE
хаашагһаа	H AA SH EH G HH AA
хаба	H A V EH
хабаадаа	H A V AA D AA
хабаадагшадые	H A V AA D EH K SH EH D Y J EH
хабаададаг	H A V AA D EH D EH K
хабаададагбди	H A V AA D EH D EH G B DJ I
хабаададагта	H A V AA D EH D EH K T EH
хабаадажа	H A V AA D EH ZH EH
хабаадалгаар	H A V AA D EH L Gr AA R
хабаадалсаһан	H A V AA D EH L S EH HH EH NG
хабаадана	H A V AA D EH N EH
хабаадуулхада	H A V AA D UUh L H EH D EH
хабаатай	H A V AA T EE
хабарай	H A V EH R EE
хабсагай	H A P S EH Gr EE
хабсагайн	H A P S EH Gr EE NG
хабсагайнай	H A P S EH Gr EE N EE
хадаа	H A D AA
хадаар	H A D AA R
хадагалаатай	H A D EH Gr EH L AA T EE
хадамда	H A D EH M D EH
хадхан	H A T H EH NG
хадын	H A D Y NG
хажуугаар	H A ZH UUh Gr AA R
хажууда	H A ZH UUh D EH
хажуудахи	H A ZH UUh D EH HJ I
хазагай	H A Z EH Gr EE
хазармонголшууд	H A Z EH R M O NG G EH L S UUh T
хайшаа	H EE SH AA
хайшан	H EE SH EH NG
хайямай	H A J A M EE
халираа	H A LJ I R AA
халуун	H A L UUh NG
халуунаар	H A L UUh N AA R
хальмагуудай	H A LJ M EH Gr UUh D EE
хамаг	H A M EH G
хамагай	H A M EH Gr EE
хамагые	H A M EH Gr Y J EH
хамарханов	H A M EH R H A N O F
хамба	H A M B EH
хамгаалалдаг	H A M G AA L EH L D EH K
хамгаалгын	H A M Gr AA L Gr Y NG
хамгаалдаг	H A M G AA L D EH K
хамгаалха	H A M G AA L H EH
хамжан	H A M ZH EH NG
хамсыгаа	H A M S Y Gr AA
хамта	H A M T EH
хамтадхаһан	H A M T EH T H EH HH EH NG
хамтараад	H A M T EH R AA T
хамтарал	H A M T EH R EH L
хамһабариин	H A M HH EH V EH RJ II NG
хан	H A NG
ханада	H A N EH D EH
ханануудынь	H A N EH N UUh D Y NJ
хананхатайгаар	H A N EH N H EH T EE Gr AA R
хангаһангүй	H A NG G EH HH EH NG G UIs
хандадаг	H A N D EH D EH K
хандахаб	H A N D EH H EH P
хандуевна	H A N D Uh J E V N A P
хандуулдаг	H A N D UUh L D EH K
хани	H A NJ I
ханхареевнатай	H A N H EH RJ E J EH V N A T EE
хара	H A R EH
хараабди	H A R AA B DJ I
хараагүйб	H A R AA Gr UIs P
хараад	H A R AA T
хараада	H A R AA D EH
хараалагданхай	H A R AA L EH G D EH N H EE
хараанда	H A R AA N D EH
хараасгайнуудай	H A R AA S H EH N UUh D EE
харагдаа	H A R EH G D AA
харагдажа	H A R EH G D EH ZH EH
харагдана	H A R EH G D EH N EH
харагдаха	H A R EH G D EH H EH
харагдаһан	H A R EH G D EH HH EH NG
харагшад	H A R EH K SH EH T
харагшадаа	H A R EH K SH EH D AA
харагшадай	H A R EH K SH EH D EE
харагшадта	H A R EH K SH EH T T EH
харагшадтаа	H A R EH K SH EH T T AA
харадаг	H A R EH D EH K
хаража	H A R EH ZH EH
харалганаадануудта	H A R EH L Gr EH N AA D EH N UUs T T EH
харалганда	H A R EH L Gr EH N D EH
харамтай	H A R EH M T EE
харана	H A R EH N EH
харанаб	H A R EH N EH P
харанат	H A R EH N EH T
харандаашууд	H A R EH N D AA SH UUh T
харанхыда	H A R EH N H Y D EH
хараха	H A R EH H EH
харахада	H A R EH H EH D EH
харахан	H A R EH H EH NG
харахаш	H A R EH H EH SH
хараһан	H A R EH HH EH NG
харбановагай	H A R V EH N O V A Gr EE
харгана	H A R Gr EH N EH
харгы	H A R Gr Y
харгыгаар	H A R Gr Y Gr AA R
харгыдаа	H A R Gr Y D AA
харгыдань	H A R Gr Y D EH NJ
хари	H A RJ I
харилсаа	H A RJ I L S AA
харилсаан	H A RJ I L S AA NG
харилсажа	H A RJ I L S EH ZH EH
харин	H A RJ I NG
хартаабхын	H A R T AA P H Y NG
хартиков	H A R TJ I K O F
хартикова	H A R TJ I K O V A
харуулаа	H A R UUh L AA
харуулаад	H A R UUh L AA T
харуулагдана	H A R UUh L EH G D EH N EH
харуулагданаа	H A R UUh L EH G D EH N AA
харуулан	H A R UUh L EH NG
харуулба	H A R UUh L V EH
харуулжа	H A R UUh L ZH EH
харуулна	H A R UUh L N EH
харуулхадань	H A R UUh L H EH D EH NJ
харуулшад	H A R UUh L SH EH T
харуулһан	H A R UUh L HH EH NG
харюултай	H A RJ UUh L T EE
хатан	H A T EH NG
хатанхай	H A T EH N H EE
хатар	H A T EH R
хатараа	H A T EH R AA
хатарааб	H A T EH R AA P
хатараар	H A T EH R AA R
хатарай	H A T EH R EE
хатарба	H A T EH R V EH
хатардаг	H A T EH R D EH K
хатареев	H A T EH RJ E J EH F
хатаржа	H A T EH R ZH EH
хатарнабди	H A T EH R N EH B DJ I
хатарнуудые	H A T EH R N UUh D Y J EH
хатарта	H A T EH R T EH
хатарха	H A T EH R H EH
хатархаар	H A T EH R H AA R
хатархаяа	H A T EH R H EH J AA
хатарша	H A T EH R SH EH
хатаршад	H A T EH R SH EH T
хатаршан	H A T EH R SH EH NG
хатарые	H A T EH R Y J EH
хатарһанаа	H A T EH R HH EH N AA
хатууе	H A T UUh J EH
хахад	H A H EH T
хахасаха	H A H EH S EH H EH
хахираар	H A HJ I R AA R
хашардалта	H A SH EH R D EH L T EH
хаһаяа	H A HH EH J AA
хеэльсинкидэ	HJ EE LJ SJ I N K EH D EH
хибэс	HJ I V EH S
хизаар	HJ I Z AA R
хизаарай	HJ I Z AA R EE
хизаарнуудаар	HJ I Z AA R N UUh D AA R
хилээмэн	HJ I L EE M EH NG
химгадалгагша	HJ I M Gr EH D EH L Gr EH K SH EH
химгадалгашадшье	HJ I M Gr EH D EH L Gr EH SH EH T SH J EH
химгадалгын	HJ I M Gr EH D EH L Gr Y NG
хиртээнгүйгөөр	HJ I R T EE NG G UIs Gr OOs R
хирэ	HJ I R EH
хирээр	HJ I R EE R
хитад	HJ I T EH T
хобто	H O P T EH
ходо	H O D EH
хододоо	H O D EH D OOh
ходол	H O D EH L
хоер	H O J EH R
хоергэрлэнхэй	H O J EH R G E R L EH N H EE
хоердохи	H O J O R D EH HJ I
хожомдохи	H O ZH EH M D EH HJ I
хоймор	H OE M EH R
хойно	H OE N EH
хойноо	H OE N OOh
хойнохоно	H OE N EH H EH N EH
хойноһоо	H OE N OOh HH OOh
хойноһоонь	H OE N OOh HH OOh NJ
хойто	H OE T EH
хойтогол	H OE T EH Gr O L
хойтоголой	H OE T EH Gr O L EE
хойшо	H OE SH EH
хойшолондоо	H OE SH EH L EH N D EH
хойшоо	H OE H OOh
холбоо	H O L V OOh
холбоон	H O L V OOh NG
холбооной	H O L V OOh N EE
холбоотой	H O L V OOh T EE
холижо	H O LJ I ZH EH
холисогүй	H O LJ I S EH Gr UIs
холисолдоһон	H O LJ I S EH L D EH HH EH NG
холо	H O L EH
холодожол	H O L EH D EH ZH EH L
холоһоо	H O L OOh HH OOh
холуур	H O L UUh R
холын	H O L Y NG
хомор	H O M EH R
хонгёо	H O NG GJ OOh
хониндо	H O NJ I N D EH
хоног	H O N EH K
хоногой	H O N EH Gr EE
хоногто	H O N EH K T EH
хонхо	H O N H EH
хоол	H OOh L
хоолойтой	H OOh L EE T EE
хоолоор	H OOh L OOh R
хоолтой	H OOh L T EE
хоорондоо	H OOh R EH N D EH
хоорондын	H OOh R EH N D Y NG
хооһон	H OOh HH EH NG
хореография	H O RJ E O G R A FJ I A
хори	H O RJ I
хоридой	H O RJ I D EE
хориин	H O RJ II NG
хорин	H O RJ I NG
хормойдо	H O R EE D EH
хорогүй	H O R EH Gr UIs
хородог	H O R EH D EH K
хоротой	H O R EH T EE
хорхой	H O R H EE
хорёо	H O RJ OOh
хото	H O T EH
хотодо	H O T EH D EH
хотоһоо	H O T EH HH OOh
хотын	H O T Y NG
хохидоһон	H O HJ I D EH HH EH NG
хоёр	H O J EH R
хоёрдохи	H O J O R D EH HJ I
хубаалдаба	H Uh V AA L V EH
хубаалдажа	H Uh V AA L D EH ZH EH
хубаалдана	H Uh V AA L D EH N EH
хубаалдахыень	H Uh V AA L D EH H Y J EH NJ
хубаалдаһан	H Uh V AA L D EH HH EH NG
хубааралга	H Uh V AA R EH L Gr EH
хубаарилгаар	H Uh V AA RJ I L Gr AA R
хуби	H Uh VJ I
хубида	H Uh VJ I D EH
хубидань	H Uh VJ I D EH NJ
хубиин	H Uh VJ II NG
хубилалтада	H Uh VJ I L EH L T EH D T EH
хубилалтанууд	H Uh VJ I L EH L T EH N UUh T
хубилгаха	H Uh VJ I L Gr EH H EH
хубитаяа	H Uh VJ I T EH J AA
хубсаһа	H Uh P S EH HH EH
хубсаһадтай	H Uh P S EH HH EH T T EE
хубсаһан	H Uh P S EH HH EH NG
хубсаһанда	H Uh P S EH HH EH N D EH
хубсаһатаяа	H Uh P S EH HH EH T EH J AA
худаг	H Uh D EH K
худал	H Uh D EH L
худалдажа	H Uh D EH L ZH EH
хужар	H Uh ZH EH R
хужарлуулыт	H Uh ZH EH R L UUh L Y T
хулгай	H Uh L Gr EE
хулгайшаниие	H Uh L Gr EE SH EH NJ II J EH
хулинсагуудай	H Uh LJ I N S EH Gr UUh D EE
хулинсагуудайнгаа	H Uh LJ I N S EH Gr UUh D EE NG G AA
хулууда	H Uh L UUh D EH
хун	H Uh NG
хурамхаан	H Uh R EH M H AA NG
хурган	H Uh R Gr EH NG
хурдандал	H Uh R D EH N D EH L
хурса	H Uh R S EH
хурсатай	H Uh R S EH T EE
хурьга	H Uh RJ Gr EH
хуу	H UUh
хуубааһан	H Uh V AA HH EH NG
хуурай	H UUh R EE
хуушаранхай	H UUh SH EH R EH NG H EE
хушажархёо	H Uh SH EH ZH EH R HJ OOh
хэ	H E
хэблэгдэнхэй	H E B L EH G D EH N H EE
хэблэгдээн	H E B L EH G D EE NG
хэблэлдэ	H E B L EH L D EH
хэблэлнүүдтэ	H E B L EH L N UUs T T EH
хэблэлэй	H E B L EH L EE
хэбэ	H E V EH
хэбэртэй	H E V EH R T EE
хэгдэжэ	H E G D EH ZH EH
хэды	H E D Y
хэдышье	H E D Y SH J EH
хэдэг	H E D EH K
хэдэн	H E D EH NG
хэжэ	H E ZH EH
хэжэл	H E ZH EH L
хэжэнгын	H E ZH EH NG G Y NG
хэзээ	H E Z EE
хэзээб	H E Z EE P
хэлсэдэг	H E L S EH D EH K
хэлсээ	H E L S EE
хэлсээн	H E L S EE NG
хэлсүүлхэгүйн	H E L S UUs L H EH Gr UIs NG
хэлые	H EH L Y J EH
хэлыень	H EH L Y J EH NJ
хэлэ	H E L EH
хэлэбэ	H EH L EH V EH
хэлэбэл	H E L EH V EH L
хэлэгдээ	H E L EH G D EE
хэлэдэг	H E L EH D EH K
хэлэеэ	H E L EE J EE
хэлэжэ	H E L EH ZH EH
хэлэжэрхидэг	H E L EH ZH E R HJ I D EH K
хэлэмнай	H E L EH M N EE
хэлэн	H E L EH NG
хэлэнгүй	H E L EH NG G UIs
хэлэндэ	H E L EH N D EH
хэлэндэнь	H EH L EH N D EH NJ
хэлэнэ	H E L EH N EH
хэлэнэй	H E L EH N EE
хэлэнэйнгээ	H EH L EH N EE NG G EE
хэлэнүүд	H E L EH N UUs T
хэлэтэй	H E L EH T EE
хэлэхэ	H EH L EH H EH
хэлэхэбши	H EH L EH H EH P SH Y
хэлэхэдэ	H EH L EH H EH D EH
хэлэхэеэ	H EH L EH H EH J EE
хэлэхээр	H E L EH H EE R
хэлээ	H E L EE
хэлээб	H EH L EE P
хэлээгүй	H E L EE Gr UIs
хэлээр	H E L EE R
хэлэһэн	H EH L EH HH EH NG
хэлэһэниинь	H E L EH HH EH NJ II NJ
хэмжээ	H E M ZH EE
хэмжээлгээрээ	H E M ZH EE L Gr EE R EE
хэмжээндэ	H E M ZH EE N D EH
хэмжээнэй	H E M ZH EE N EE
хэмжээтэйгээр	H E M ZH EE T EE Gr EE R
хэн	H E NG
хэнхэй	H E N H EE
хэншье	H E N SH J EH
хэнэбди	H E N EH B DJ I
хэнэй	H E N EE
хэр	H E R
хэрбэеэ	H E R V EH J EE
хэрбээ	H E R V EE
хэрэг	H E R EH K
хэрэггүй	H E R EH G G UIs
хэрэглэгдэхэеэ	H E R EH G L EH G D EH H EH J EE
хэрэглэжэ	H E R EH G L EH ZH EH
хэрэглэн	H E R EH G L EH NG
хэрэглэхэ	H E R EH G L EH H EH
хэрэглэһэн	H E R EH G L EH HH EH NG
хэрэгнай	H E R EH G N EE
хэрэгсэлээ	H E R EH G S EH L EE
хэрэгтэ	H E R EH K T EH
хэрэгтэй	H E R EH K T EE
хэрэгээ	H E R EH Gr EE
хэрэгүүд	H E R EH Gr UUs T
хэрэм	H E R EH M
хэрэнэй	H E R EH N EE
хэсуу	H EH S UUh
хэсүү	H E S UUs
хэтын	H E T Y NG
хэтэдэ	H E T EH D EH
хэхээр	H E H EE R
хэшээл	H E SH EE L
хэшээлынь	H E SH EE L Y NJ
хэшээлээ	H E SH EE L EE
хээлитэй	H EE LJ I T EE
хүбшэргэйе	H Us P SH EH R Gr EE J EH
хүбүүгээ	H Us V UUs Gr EE
хүбүүд	H Us V UUs T
хүбүүдтэй	H Us V UUs T T EE
хүбүүдые	H Us V UUs D Y J EH
хүбүүдэй	H Us V UUs D EE
хүбүүдээ	H Us V UUs D EE
хүбүүе	H Us V UUs J EH
хүбүүмнай	H Us V UUs M N EE
хүбүүн	H Us V UUs NG
хүбүүндэ	H Us V UUs N D EH
хүбүүндээ	H Us V UUs N D EE
хүбүүтэйб	H Us V UUs T EE P
хүбүүхэн	H Us V UUs H EH NG
хүбүүхэнэй	H Us V UUs H EH N EE
хүгжэлтые	H Us G ZH EH L T Y J EH
хүгжэлтын	H Us G ZH EH L T Y NG
хүгжэлтэ	H Us G ZH EH L T EH
хүгжэлтэдэ	H Us G ZH EH L T EH D EH
хүгжэм	H Us G ZH EH M
хүгжэмшэд	H Us G ZH EH M SH EH T
хүгжэмөөр	H Us G ZH EH M OOs R
хүгжэнги	H Us G ZH EH NG GJ I
хүгжэхэ	H Us G ZH EH H EH
хүгжэһэн	H Us G ZH EH HH EH NG
хүгжөө	H Us G ZH OOs
хүгжөөжэ	H Us G ZH OOs ZH EH
хүгжөөлхэдэ	H Us G ZH OOs L H EH D EH
хүгжөөнэ	H Us G ZH OOs N EH
хүгжөөнэгүй	H Us G ZH OOs N EH Gr UIs
хүгжөөхөөр	H Us G ZH OOs H OOs R
хүгшэд	H Us G SH EH T
хүгшэдые	H Us G SH EH D Y J EH
хүгшэн	H Us G SH EH NG
хүдэлгэн	H Us D EH L Gr EH NG
хүдэлгэһэнөө	H Us D EH L Gr EH HH EH N OOh
хүдэлгүүр	H Us D EH L Gr UUs R
хүдэлгүүртэй	H Us D EH L Gr UUs R T EE
хүдэлгөөжэ	H Us D EH L Gr OOs ZH EH
хүдэлдэг	H Us D EH L D EH K
хүдэлжэ	H Us D EH L ZH EH
хүдэлмэридэ	H Us D EH L M EH RJ I D EH
хүдэлмэрилжэ	H Us D EH L M EH RJ I L ZH EH
хүдэлмэримнай	H Us D EH L M EH RJ I M N EE
хүдэлмэришэ	H Us D EH L M EH RJ I SH EH
хүдэлхыень	H Us D EH L H Y J EH NJ
хүдэлхэ	H Us D EH L H EH
хүдэлхэгүй	H Us D EH L H EH Gr UIs
хүдэлхэдөө	H Us D EH L H EH D OOs
хүдэлхэеэ	H Us D EH L H EH J EE
хүдэлһэн	H Us D EH L HH EH NG
хүдэлөө	H Us D EH L OOs
хүдэлөөд	H Us D EH L OOs T
хүдөө	H Us D OOs
хүдөөгэй	H Us D OOs Gr EE
хүдөөгэймнай	H Us D OOs Gr EH M N EE
хүдөөһөө	H Us D OOs HH OOs
хүзүүбшэ	H Us Z UUs P SH EH
хүйтэн	H UIs T EH NG
хуйтэн	H UIs T EH NG
хүйһөөрөө	H UIs HH OOs R OOs
хүл	H Us L
хүлгэн	H Us L Gr EH NG
хүлгөөдэг	H Us L Gr OOs D EH G
хүлгөөндэ	H Us L Gr OOs N D EH
хүлгөөнһөө	H Us L Gr OOs N HH OOs
хүлеэжэ	H Us LJ EE ZH EH
хүлеэсэтэй	H Us LJ EE S EH T EE
хүлеэхэ	H Us LJ EE H EH
хүлөө	H Us L OOs
хүм	H Us M
хүмүүжүүлгын	H Us M UUs ZH UUs L Gr Y NG
хүмүүжүүлжэ	H Us M UUs ZH UUs L ZH EH
хүмүүжүүлнэ	H Us M UUs ZH UUs L N EH
хүн	H Us NG
хүнби	H Us NG BJ I
хүнгэн	H Us NG G EH NG
хүнгэхэнөөр	H Us NG G EH H EH N OOs R
хүндые	H Us N D Y J EH
хүндэ	H Us N D EH
хүндэлхэ	H Us N D EH L H EH
хүндэлэн	H Us N D EH L EH NG
хүндэлһэн	H Us N D EH L HH EH NG
хүндэмүүшэ	H Us N D EH M UUs SH EH
хүндэтэ	H Us N D EH T EH
хүндэтэй	H Us N D EH T EE
хүндөөр	H Us N D OOs R
хүниие	H Us NJ II J EH
хүнта	H Us N T EH
хүнэй	H Us N EE
хүнүүд	H Us N UUs T
хүнүүдтэ	H Us N UUs T T EH
хүнүүдтэй	H Us N UUs T T EE
хүнүүдэй	H Us N UUs D EE
хүнүүдээр	H Us N UUs D EE R
хүргэдэг	H Us R Gr EH D EH K
хүргэнэб	H Us R Gr EH N EH P
хүргэхэ	H Us R Gr EH H EH
хүрин	H Us RJ I NG
хүртэбэ	H Us R T EH V EH
хүртэнхэй	H Us R T EH N H EE
хүртэнэ	H Us R T EH N EH
хүртэһэн	H Us R T EH HH EH NG
хүрьгэниинь	H Us RJ Gr EH NJ II NJ
хүрьһэтэй	H Us RJ HH EH T EE
хүрэжэ	H Us R EH ZH EH
хүрэнэ	H Us R EH N EH
хүрэтэр	H Us R EH T EH R
хүрэтэрөө	H Us R EH T EH R OOs
хүрэхэдөө	H Us R EH H EH D OOs
хүрэһэн	H Us R EH HH EH NG
хүсэ	H Us S EH
хүсэжэ	H Us S EH ZH EH
хүсэлдэшэхэдэнь	H Us S EH L D EH SH EH H EH D EH NJ
хүсэлтэйб	H Us S EH L T EE P
хүсэлтэйбди	H Us S EH L T EE B DJ I
хүсэлөө	H O S EH L OOs
хүсэн	H Us S EH NG
хүсэндэ	H Us S EH N D EH
хүсэнтэй	H Us S EH N T EE
хүсэнэб	H Us S EH N EH P
хүсэнэй	H Us S EH N EE
хүсэтэй	H Us S EH T EE
хүсэхөөр	H Us S EH H OOs R
хүсэһэн	H Us S EH HH EH NG
хүсөөтэдэ	H Us S OOs T EH D EE
хүтэлбэри	H Us T EH L V EH RJ I
хүтэлбэрииин	H Us T EH L V EH RJ II NG
хүтэлбэрилхэдэ	H Us T EH L V EH RJ I L H EH D EH
хүтэлбэрилэгшэ	H Us T EH L V EH RJ I K SH EH
хүтэлбэрилэгшэт	H Us T EH L V EH RJ I K SH EH T
хүтэлбэрилэгшөөр	H Us T EH L V EH RJ I K SH OOs R
хүтэлбэритэй	H Us T EH L V EH RJ I T EE
хүтэрэлдөөд	H Us T EH R EH L D OOs T
хүхэ	H Us H EH
хүхюу	H Us HJ UUh
хүхюун	H Us HJ UUh NG
хүхюутэй	H Us HJ UUh T EE
хүхюутэйгөөр	H Us HJ UUh T EE Gr OOs R
хүшэрхэн	H Us SH EH R H EH NG
хүшөө	H Us SH OOs
хүүгэд	H UUs Gr EH T
хүүгэдни	H UUs Gr EH D NJ I
хүүгэдтэ	H UUs Gr EH T T EH
хүүгэдтэй	H UUs Gr EH T T EE
хүүгэдтээ	H UUs Gr EH T T EE
хүүгэдые	H UUs Gr EH D Y J EH
хүүгэдэй	H UUs Gr EH D EE
хүүндэ	H UUs N D EH
хүүнүүд	H UUs N UUs T
хүүртээ	H UUs R T EE
хөөрхэн	H OOs R H EH NG
хөөрэгдэнэ	H OOs R EH G D EH N EH
хөөрэдэг	H OOs R D EH D EH K
хөөрэжэ	H OOs R EH ZH EH
хөөрэлдэжэ	H OOs R EH L D EH ZH EH
хөөрэлдөөд	H OOs R EH L D OOs T
хөөрэлдөөн	H OOs R EH L D OOs NG
хөөрэлдөөндэ	H OOs R EH L D OOs N D EH
хөөрэнгүй	H OOs R EH NG G UIs
хөөрэнэ	H OOs R EH N EH
хөөрөөгөө	H OOs R OOs Gr OOs
хөөрөөнэй	H OOs R OOs N EE
хөөрөөнүүдыень	H OOs R OOs N UUs D Y J EH NJ
цыденов	C Y DJ E N O V
цыденова	C Y DJ E N O V A
цыдып	C Y D Y P
цыдыпова	C Y D Y P O V A
цындыма	C Y N D Y M A
цыпелма	C Y PJ E L M A
цыпелмаагай	C Y PJ E L M AA Gr EE
цыпелмаае	C Y PJ E L M AA J EH
цыпелмагай	C Y PJ E L M A Gr EE
цыпелмада	C Y PJ E L M A D EH
цыпелмае	C Y PJ E L M A J EH
цыренгармаев	C Y RJ E N G A R M A J E F
цыренгармаевые	C Y RJ E N G A R M A J E V Y J E
цыренгармын	C Y RJ E NG G A R M Y NG
цырендашиев	C Y RJ E N D A SH Y J E F
цырендоржиев	C Y RJ E N D O R ZH Y J E F
цырендоржиевна  C Y RJ E N D O R ZH Y J E V N A
цыренжапов	C Y RJ E N ZH A P O F
цыреноватай	C Y RJ E N O V A T EE
цыцык	C Y C Y K
чагатай	CH A Gr EH T EE
чемпион	CH E M PJ I O NG
чимитов	CH I MJ I T O F
чингис	CH I N GJ I S
чингисхаан	CH I N GJ I S H AA NG
чингисхаанай	CH I N GJ I S H AA N EE
чингисхана	CH I N GJ I S H EH N EH
шабинартань	SH A VJ I N EH R T EH NJ
шагнажа	SH A G N EH ZH EH
шагнаха	SH A G N EH H EH
шадаа	SH A D AA
шадабари	SH A D EH V EH RJ I
шадабарида	SH A D EH V EH RJ I D EH
шадабарииень	SH A D EH V EH RJ II J EH NJ
шадабаритай	SH A D EH V EH RJ I T EE
шадабаряараа	SH A D EH V EH RJ AA R AA
шададаг	SH A D EH D EH K
шадал	SH A D EH L
шадалаа	SH A D EH L AA
шадалтай	SH A D EH L T EE
шадалые	SH A D EH L Y J EH
шадана	SH A D EH N EH
шадар	SH A D EH R
шадараар	SH A D EH R AA R
шадаха	SH A D EH H EH
шажан	SH A ZH EH NG
шаланова	SH A L A N O V A
шалановае	SH A L A N O V A J EH
шалгалта	SH A L Gr EH L T EH
шалгаран	SH A L Gr EH R EH NG
шалгаруулха	SH A L Gr EH R UUh L H EH
шалгаха	SH A L Gr EH H EH
шалтаад	SH A L T AA T
шалтагһаа	SH A L T EH G HH AA
шамайе	SH A M EE J EH
шамда	SH A M D EH
шамтай	SH A M T EE
шанагаяа	SH A N EH Gr EH J AA
шанажа	SH A N EH ZH EH
шаналга	SH A N EH L Gr EH
шанар	SH A N EH R
шанартай	SH A N EH R T EE
шанартайе	SH A N EH R T EE J EH
шанга	SH A NG G EH
шангай	SH A NG G EE
шанда	SH A N D EH
шандаганай	SH A N D EH Gr EH N EE
шандаганда	SH A N D EH Gr EH N D EH
шараа	SH A R AA
шарайтай	SH A R EE T EE
шарайшье	SH A R EE SH J EH
шараһан	SH A R EH HH EH NG
шата	SH A T EH
шатаар	SH A T AA R
шаташаһан	SH A T EH SH EH HH EH NG
шатын	SH A T Y NG
шах	SH A H
шахуу	SH A H UUh
швециин	SH VJ E C Y NG
шеметова	SH E MJ E T O V A
шенхоров	SH E N H O R O F
шенхорова	SH E N H O R O V A
шенхоровагай	SH E N H O R O V A Gr EE
шенхоровтоной	SH E N H O R O F T EH N EE
ши	SH Y
шииг	SH Y K
шиидхэбэл	SH Y T H EH V EH L
шиидхэгдээгүй	SH Y T H EH G D EE Gr UIs
шиидхэхы	SH Y T H EH H Y
шиидхэхэ	SH Y T H EH H EH
шиидэһэн	SH Y D EH HH EH NG
шинии	SH Uh NJ II
шишкинские	SH Y SH KJ I N S KJ I J E
шкаф	SH K A F
шог	SH O K
шогтой	SH O K T EE
шонхо	SH O N H EH
шоо	SH OOh
шоройдожо	SH O R EE D EH ZH EH
шпагат	SH P A G A T
шри	SH RJ I
шубууд	SH Uh V UUh T
шубуун	SH Uh V UUh NG
шугам	SH Uh Gr EH M
шугамууд	SH Uh Gr EH M UUh T
шудалагдажал	SH Uh D EH L EH G D EH ZH EH L
шудалагдан	SH Uh D EH L EH G L EH NG
шудалалга	SH Uh D EH L EH L Gr EH
шудалалгада	SH Uh D EH L EH L Gr EH D EH
шудалалгын	SH Uh D EH L EH L Gr Y NG
шудалдаг	SH Uh D EH L D EH K
шудалжал	SH Uh D EH L ZH EH L
шудалха	SH Uh D EH L H EH
шудалхаар	SH Uh D EH L H AA R
шудалһан	SH Uh D EH L HH EH NG
шударгы	SH Uh D EH R Gr Y
шулуу	SH Uh L UUh
шулуун	SH Uh L UUh NG
шулуунууд	SH Uh L UUh N UUh T
шуналтай	SH Uh N EH L T EE
шунгалга	SH Uh NG EH L Gr EH
шуран	SH Uh R EH NG
шуугаа	SH UUh Gr AA
шуумайса	SH UUh M EE S EH
шуурган	SH UUh R Gr EH NG
шууяа	SH UUh J AA
шууялдаан	SH UUh J A L D AA NG
шухала	SH Uh H EH L EH
шэбхэдэдэггүйбди	SH E P H EH D EH D EH G G UIs B DJ I
шэбхэдэнэгүй	SH E P H EH D EH N EH Gr UIs
шэбшэбэ	SH E P SH EH V EH
шэбэртэ	SH E V EH R T EH
шэбэртэеэ	SH E V EH R T EH J EE
шэглэлтэй	SH E G L EH L T EE
шэди	SH E DJ I
шэдитэ	SH E DJ I T EH
шэлэгдээ	SH E L EH G D EE
шэлэдэг	SH E L EH D EH K
шэлэдэгдэхээр	SH E L EH D EH G D EH H EE R
шэлэжэ	SH E L EH ZH EH
шэлэн	SH E L EH NG
шэлэхэ	SH E L EH H EH
шэмэг	SH E M EH K
шэмэглэжэрхёо	SH E M EH G L EH ZH EH R HJ OOh
шэмээшэгүүд	SH E M EE SH EH Gr UUs T
шэнгеэр	SH E NG GJ EE R
шэнги	SH E NG GJ I
шэнгэжэ	SH E NG G EH ZH EH
шэнгэн	SH E NG G EH NG
шэнгэрүүһэд	SH E NG G EH R UUs HH EH T
шэнжэлбэб	SH E N ZH EH L V EH P
шэнжэлдэг	SH E N ZH EH L D EH K
шэнжэлхэеэ	SH E N ZH EH L H EH J EE
шэнжэлэгдээ	SH E N ZH EH L EH G D EE
шэнжэлэн	SH E N ZH EH L EH N
шэнжэнүүд	SH E N ZH EH N UUs T
шэнжэтэй	SH E N ZH EH T EE
шэнхинээн	SH E N HJ I N EE NG
шэнэ	SH E N EH
шэрдэг	SH E R D EH G
шэртэн	SH E R T EH NG
шэрэ	SH E R EH
шэтэ	SH E T EH
шэхэндэ	SH E H EH N D EH
шүдэнэй	SH Us D EH N EE
шүлыень	SH Us L Y J EH NJ
шүлэг	SH Us L EH K
шүлэгдэмэл	SH Us L EH G D EH M EH L
шүлэгшын	SH Us L EH K SH Y NG
шүлэгшэ	SH Us L EH K SH EH
шүлэгэй	SH Us L EH Gr EE
шүлэгүүд	SH Us L EH Gr UUs T
шүлэгүүдыень	SH Us L EH Gr UUs D Y J EH NJ
шүлэгүүдэй	SH Us L EH Gr UUs D EE
шүлэгүүдээ	SH Us L EH Gr UUs D EE
шүлэгүүдээр	SH Us L EH Gr UUs D EE R
шүлэгүүдээрээ	SH Us L EH Gr UUs D EE R EE
шүлэгөөрөө	SH Us L EH G OOs R OOs
шүлһэ	SH Us L HH EH
шүтэлгын	SH Us T EH L Gr Y NG
шүүжэ	SH UUh ZH EH
шүүлэгүүдэй	SH UUh L EH Gr UUs D EE
эбтэй	E P T EE
эвенкнүүдтэй	E VJ E N K N UUs T T EE
эгэшэ	E Gr EH SH EH
эгээ	E Gr EE
эгээл	E Gr EE L
эдеэ	E DJ EE
эдеэгээ	E DJ EE Gr EE
эдеэгээр	E DJ EE Gr EE R
эдеэлхэ	E DJ EE L H EH
эдеэлүүлхэдээ	E DJ EE L UUs L H EH D EE
эди	E DJ I
эдижэ	E DJ I ZH EH
эдир	E DJ I R
эдиршүүлдэ	E DJ I R SH UUs L D EH
эдлээ	E T L EE
эдэ	E D EH
эдэбхи	E D EH P HJ I
эдэбхитэй	E D EH P HJ I T EE
эдэбхитэйгээр	E D EH P HJ I T EE Gr EE R
эетэй	E J EH T EE
эжы	E ZH Y
эжыдээ	E ZH Y D EE
эжые	E ZH Y J EH
эжымни	E ZH Y M NJ I
эжын	E ZH Y NG
эжынь	E ZH Y NJ
эжэл	E ZH EH L
эжэлүүдгүй	E ZH EH L UUs D G UIs
эзэлхын	E Z EH L H Y NG
эзэмдэжэ	E Z EH M D EH ZH EH
эзэмдэн	E Z EH M D EH NG
эзэн	E Z EH NG
экспедицеэр	E K S PJ E DJ I C EE R
экспедицимнай	E K S PJ E DJ I C EH M N EE
экшн	E K SH NG
элбэг	E L V EH K
элдэб	E L D EH P
элдэбын	E L D EH V Y NG
элдэдэг	E L D EH D EH K
электронно	E LJ E K T R O N EH
элидхэлнүүд	E LJ I T H EH L N UUs T
элинсэг	E LJ I N S EH K
элинсэгэй	E LJ I N S EH Gr EE
элирүүлэгдээ	E LJ I R UUs L EH G D EE
элитэ	E LJ I T EH
элсүүлэнхэй	E L S UUs L EH N H EE
элшэтэ	E L SH EH T EH
эльбээд	E LJ V EE T
эльгээгдэһээн	E LJ G EE G D EH HH EE NG
эльгээхые	E LJ G EE H Y J EH
элүүр	E L UUs R
элһэнби	E L HH EH NG BJ I
эм	E M
эмхи	E M HJ I
эмхидхэгдэжэ	E M HJ I T H EH G D EH ZH EH
эмхидхэгдэһэн	E M HJ I T H EH G D EH HH EH NG
эмхидхэдэг	E M HJ I T H EH D EH K
эмхидхэхээр	E M HJ I T H EH H EE R
эмхидхээ	E M HJ I T H EE
эмхидхэһэн	E M HJ I T H EH HH EH NG
эмхинүүд	E M HJ I N UUs T
эндэ	E N D EH
эндэһээ	E N D EH HH EE
энеэбхилэн	E NJ EE P HJ I L EH NG
энеэдэн	E NJ EE D EH NG
энеэлдэн	E NJ EE L D EH NG
энеэнэ	E NJ EE N EH
энхэ	E N H EH
энэ	E N EH
энэдхэг	E N EH T H EH K
энэдхэгтэ	E N EH T H EH K T EH
энэдхэгэй	E N EH T H EH Gr EE
энэл	E N EH L
энэнь	E N EH NJ
энэшни	E N EH SH NJ I
энээн	E N EE NG
энээндэнь	E N EE N D EH NJ
энээниие	E N EE NJ II J EH
энээхэн	E N EE H EH NG
энээхэндэ	E N EE H EH N D EH
энээхэниие	E N EE H EH NJ II J EH
энэһээ	E N EH HH EE
экономико   E K O N O MJ I K EH
эрдэм	E R D EH M
эрдэмтэд	E R D EH M T EH T
эрдэмтэдэй	E R D EH M T EH D EE
эрдэмтэн	E R D EH M T EH NG
эрдэмтэниие	E R D EH M T EH NJ II J EH
эрилтын	E RJ I L T Y NG
эрилтэ	E RJ I L T EH
эрмэлзэжэ	E R M EH L Z EH ZH EH
эртэ	E R T EH
эрхилжэ	E R HJ I L ZH EH
эрхилхэдэл	E R HJ I L H EH D EH L
эрхилэгшэд	E R HJ I L EH K SH EH T
эрхилэгшэдһээшье	E R HJ I L EH K SH EH T HH EE SH J EH
эрхые	E R H Y J EH
эрхэ	E R H EH
эрхүү	E R H UUs
эрхүүгэй	E R H UUs Gr EE
эрхүүгэйхид	E R H UUs Gr EE HJ I T
эршэ	E R SH EH
эршэмтэй	E R SH EH M T EE
эршэтэйгээр	E R SH EH T EE Gr EE R
эрье	E RJ J EH
эрьедэ	E RJ J EH D EH
эрьелдэнэ	E RJ J EH L D EH
эрьеэр	E RJ J EE R
эрэ	E R EH
эрэшүүлэй	E R EH SH UUs L EE
эрэһэн	E R EH HH EH NG
эсэбэритэй	E S EH V EH RJ I T EE
эсэгыемни	E S EH Gr Y J EH M NJ I
эсэгынгээ	E S EH Gr Y NG G EE
эсэгынгээл	E S EH Gr Y NG G EE L
эсэгэ	E S EH Gr EH
эсэгэдэнь	E S EH Gr EH D EH NJ
эсэгэдээ	E S EH Gr EH D EE
эсэгэеэ	E S EH Gr EH J EE
эсэгэмни	E S EH Gr EH M NJ I
эсэгэнь	E S EH Gr EH NJ
эсэгэнэрэйнгээ	E S EH Gr EH N EH R EE NG G EE
этигэл	E TJ I Gr EH L
этигэнэгүй	E TJ I Gr EH N EH Gr UIs
этнографическа	E T N EH G R A FJ I CH EH S K EH
эхилбэ	E HJ I L V EH
эхилжэ	E HJ I L ZH EH
эхилхэ	E HJ I L H EH
эхилхэдэнь	E HJ I L H EH D EH NJ
эхилхэдээ	E HJ I L H EH D EE
эхилхэдээл	E HJ I L H EH N D EE L
эхилээ	E HJ I L EE
эхилээб	E HJ I L EE P
эхилээд	E HJ I L EE T
эхилһэн	E HJ I L HH EH NG
эхин	E HJ I NG
эхиндэ	E HJ I N D EH
эхирэдбулагадай	E HJ I R EH D B Uh L EH Gr EH D EE
эхитэй	E HJ I T EE
эхынгээ	E H Y NG G EE
эхэ	E H EH
эхэнэр	E H EH N EH R
эшхэбтэр	E SH H EH P T EH R
эшэнгүй	E SH EH NG G UIs
эшэхэ	E SH EH H EH
ээрсэгээр	EE R S EH Gr EE R
ээрэжэ	EE R EH ZH EH
юм	J Uh M
юмбибди	J Uh M BJ I B DJ I
юрэ	J Uh R EH
юрэдөөл	J Uh R EH D OOs L
юрэнхылэгшэ	J Uh R EH N H Y L EH K SH EH
юрөө	J Uh R OOs
юу	J UUh
юуб	J UUh P
юугээр	J UUh Gr EE R
юугээрээ	J UUh Gr EE R EE
юум	J UUh M
юумыешни	J UUh M Y J EH SH NJ I
юумэ	J UUh M EH
юумэеэ	J UUh M EH J EE
юумэн	J UUh M EH NG
юумэндэ	J UUh M EH N D EH
юумэнэйнь	J UUh M EH N EE NJ
юумэнүүдые	J UUh M EH N UUs D Y J EH
юун	J UUh NG
юундэ	J UUh N D EH
юундэб	J UUh N D EH P
юуншье	J UUh N SH J EH
юунһээшье	J UUh N HH EE SH J EH
юһэдэхи	J Uh HH EH D EH HJ I
юһэн	J Uh HH EH NG
яажа	J AA ZH EH
яарадаггүйб	J AA R EH D EH G G UIs P
яаралгүй	J AA R EH L Gr UIs
яаралгүйхэн	J AA R EH L Gr UIs H EH NG
яахабши	J AA H EH P SH Y
ябаа	J A V AA
ябаарай	J A V AA R EE
ябаба	J A V EH V EH
ябадал	J A V EH D EH L
ябажа	J A V EH ZH EH
ябалган	J A V EH L Gr EH NG
ябалсааб	J A V EH L S AA P
ябана	J A V EH N EH
ябаха	J A V EH H EH
ябахада	J A V EH H EH D EH
ябахадаа	J A V EH H EH D AA
ябахадаал	J A V EH H EH D AA L
ябахадань	J A V EH H EH D EH NJ
ябахаяа	J A V EH H EH J AA
ябахыень	J A V EH H Y J EH NJ
ябахын	J A V EH H Y NG
ябаһаар	J A V EH HH AA R
ябаһан	J A V EH HH EH NG
ябуулаад	J A V UUh L AA T
ябуулагдаа	J A V UUh L EH G D AA
ябуулагшад	J A V UUh L EH G SH EH T
ябуулгаад	J A V UUh L Gr AA T
ябуулжа	J A V UUh L ZH EH
ябуулна	J A V UUh L N EH
ядалдаагүй	J A D EH L D AA Gr UIs
ядалсадаг	J A D EH L S EH D EH K
ядаха	J A D EH H EH
ядахагүйб	J A D EH H EH Gr UIs P
якутск	J A K Uh T S K
ялараа	J A L EH R AA
ялас	J A L EH S
ямар	J A M EH R
ямараар	J A M EH R AA R
ямаршье	J A M EH R SH J EH
январь	J A N V A RJ
янзын	J A N Z Y NG
янхаевтан	J A N H A J EH V T EH NG
япон	J A P O NG
яхадай	J A H EH D EE
яһала	J A HH EH L EH
яһанай	J A HH EH N EE
яһатан	J A HH EH T EH NG
яһатанай	J A HH EH T EH N EE
ёг	J O K
ёохор	J OOh H EH R
ёһо	J O HH EH
ёһоор	J O HH OOh R
ёһоороо	J O HH OOh R OOh
ёһотой	J O HH EH T EE
ёһотойл	J O HH EH T EE L
үбгэ	Us V Gr EH
үбгэд	Us V Gr EH T
үбшые	Us P SH Y J EH
үглөөгүүр	Us G L OOs Gr UUs R
үгтэдэг	Us K T EH D EH K
үгтэнэ	Us K T EH N EH
үгтэһэн	Us K T EH HH EH NG
үгы	Us Gr Y
үгыбши	Us Gr Y P SH Y
үгыдэ	Us Gr Y D EH
үгые	Us Gr Y J EH
үгылнэ	Us Gr Y L N EH
үгыт	Us Gr Y T
үгэ	Us Gr EH
үгэбэ	Us Gr EH V EH
үгэгдэһэн	Us Gr EH G D EH HH EH NG
үгэдэ	Us Gr EH D EH
үгэдэг	Us Gr EH D EH K
үгэнэ	Us Gr EH N EH
үгэнүүд	Us Gr EH N UUs T
үгэшье	Us Gr EH SH J EH
үгэһэн	Us Gr EH HH EH NG
үгөө	Us Gr OOs
үгөөб	Us Gr OOs P
үгөөрөө	Us Gr OOs R OOs
үдын	Us D Y NG
үдэ	Us D EH
үдэр	Us D EH R
үдэрнүүд	Us D EH R N UUs T
үдэрнүүдтэ	Us D EH R N UUs T T EH
үдэрнүүдые	Us D EH R N UUs D Y J EH
үдэшын	Us D EH SH Y NG
үдэшэ	Us D EH SH EH
үдэшэндөө	Us D EH SH EH N D OOs
үе	Us J EH
үедэ	Us J EH D EH
үедэнь	Us J EH D EH NJ
үедөө	Us J EH D OOs
үерлэн	Us J EH R L EH NG
үетэнөө	Us J EH T EH N OOs
үеын	Us J E Y NG
үеһөө	Us J EH HH OOs
үзэгдэдэг	Us Z EH G D EH D EH K
үзэгдэнэ	Us Z EH G D EH N EH
үзэдэггүйб	Us Z EH D EH G G UIs P
үзэдэгынь	Us Z EH D EH Gr Y NJ
үзэе	Us Z EH J EH
үзэжэ	Us Z EH ZH EH
үзэлгэ	Us Z EH L Gr EH
үзэлшэн	Us Z EH L SH EH NG
үзэсхэлэн	Us Z EH S H EH L EH NG
үзэсхэлэнтэ	Us Z EH S H EH L EH N T EH
үзэхэ	Us Z EH H EH
үзэхэгүй	Us Z EH H EH Gr UIs
үзэхэдэ	Us Z EH H EH D EH
үзэһэн	Us Z EH HH EH NG
үзүүлдэг	Us Z UUs L D EH K
үзүүлжэ	Us Z UUs L ZH EH
үзүүлхэ	Us Z UUs L H EH
үзүүлэгдэхэ	Us Z UUs L EH G D EH H EH
үзүүлһэн	Us Z UUs L HH EH NG
үзөөгүй	Us Z OOs Gr UIs
үй	UIs
үйлын	UIs L Y NG
үйлэ	UIs L EH
үйлэдбэрилхэ	UIs L EH D B EH RJ I L H EH
үйлэдбэрилһэн	UIs L EH D B EH RJ I L HH EH NG
үйлэдэхэ	UIs L EH D EH H EH
үлгы	Us L Gr Y
үлгөөтэй	Us L Gr OOs T EE
үлир	Us LJ I R
үлэн	Us L EH NG
үлэнхэй	Us L EH N H EE
үлэшоо	Us L EH SH OOh
үлэшэнэ	Us L EH SH EH N EH
үлэшэһэн	Us L EH SH EH HH EH NG
үлүү	Us L UUs
үлөөд	Us L OOs T
үлөөһэн	Us L OOs HH EH NG
үмсын	Us M S Y NG
үмөөрөөд	Us M OOs R OOs T
үнгэргэгдэһэн	Us NG G EH R Gr EH G D EH HH EH NG
үнгэргэгдөө	Us NG G EH R Gr EH G D OOs
үнгэргэхэ	Us NG G EH R H EH D EH
үнгэргөө	Us NG G EH R Gr OOs
үнгэрдэг	Us NG G EH R D EH K
үнгэрхэдөө	Us NG G EH R H EH D OOs
үнгэрэгшэ	Us NG G EH R EH G SH EH
үнгэрэмсөөр	Us NG G EH R EH M S OOs R
үнгэрһэн	Us NG G EH R EH HH EH NG
үнгэрөө	Us NG G EH R OOs
үнгэрөөб	Us NG G EH R OOs P
үнгэтэ	Us NG G EH T EH
үнгэтэй	Us NG G EH T EE
үндын	Us N D Y NG
үндыһэн	Us N D Y HH EH NG
үндэр	Us N D EH R
үндэһэд	Us N D EH HH EH T
үндэһэн	Us N D EH HH EH NG
үндэһэнһөө	Us N D EH HH EH N HH OOs
үндэһэтэ	Us N D EH HH EH T EH
үнеэ	Us NJ EE
үнжэгэн	Us N ZH EH Gr EH NG
үни	Us NJ I
үншэршэнхэй	Us N SH EH R SH EH N H EE
үнэн	Us N EH NG
үнэндөө	Us N EH N D OOs
үнэр	Us N EH R
үнэтэ	Us N EH T EH
үнэтэй	Us N EH T EE
үнэхөөрөө	Us N EH H OOs R OOs
үнэхөөрөөл	Us N EH H OOs R OOs L
үнөөхи	Us N OOs HJ I
үргэе	Us R Gr EH J EH
үргэлжэ	Us R Gr EH L ZH EH
үргэлжэлүүлэгдээ	Us R Gr EH L ZH E L UUs L EH G D EE
үргэн	Us R Gr EH NG
үргэнэ	Us R Gr EH N EH
үргэнөөр	Us R Gr EH N OOs R
үргөө	Us R Gr OOs
үргөөш	Us R Gr OOs SH
үрдеэгүй	Us R DJ EE Gr UIs
үреэ	Us RJ EE
үри	Us RJ I
үринь	Us RJ I NJ
үрхэ	Us R H EH
үрэжэлтэй	Us R EH ZH EH L T EE
үсхэлдэрэйхи	Us S H EH L D EH R EE HJ I
үсэгэлдэр	Us S EH Gr EH L D EH R
үсэгэлдэртөө	Us S EH Gr EH L D EH R T OOs
үсөөн	Us S OOs NG
үсөөрөө	Us S OOs R OOs
үтэрхэн	Us T EH R H EH NG
үхибүүд	Us HJ I V UUs T
үхибүүднай	Us HJ I V UUs D N EE
үхибүүдтэ	Us HJ I V UUs T T EH
үхибүүдые	Us HJ I V UUs D Y J EH
үхибүүдэй	Us HJ I V UUs D EE
үхибүүдэйнгээ	Us HJ I V UUs D EE NG G EE
үхибүүн	Us HJ I V UUs NG
үхибүүндээ	Us HJ I V UUs N D EE
үхибүүниинь	Us HJ I V UUs NJ II NJ
үхибүүтэй	Us HJ I V UUs T EE
үхэр	Us H EH R
үхэрнүүд	Us H EH R N UUs T
үхэртэй	Us H EH R T EE
үхэхэш	Us H EH H EH SH
үшөө	Us SH OOs
үшөөл	Us SH OOs L
үшөөшье	Us SH OOs SH J EH
үүдэ	UUs D EH
үүдэн	UUs D EH NG
үүдэнэй	UUs D EH N EE
үүдэшэн	UUs D EH SH EH NG
үүдэшэнөөр	UUs D EH SH EH N OOs R
үүдээ	UUs D EE
үүргэ	UUs R Gr EH
үүргэтэй	UUs R Gr EH T EE
үүсхэл	UUs S H EH L
һаа	HH AA
һаалган	HH AA L Gr EH NG
һаам	HH AA M
һаамнай	HH AA M N EE
һаамни	HH AA M NJ I
һаань	HH AA NJ
һаданар	HH A D EH N EH R
һадаһад	HH A D EH HH EH T
һадаһадай	HH A D EH HH EH D EE
һадаһаднай	HH A D EH HH EH D N EE
һажаажа	HH A ZH AA ZH EH
һажаанхай	HH A ZH AA N H EE
һайжаруулхаар	HH EE ZH EH R UUh L H AA R
һайн	HH EE NG
һайнаар	HH EE N AA R
һайнааршье	HH EE N AA R SH J EH
һайндэр	HH EE N D EH R
һайндэрнүүдые	HH EE N D EH R N UUs D Y J EH
һайндэртэ	HH EE N D EH R T EH
һайнууд	HH EE N UUh T
һайса	HH EE S EH
һайхан	HH EE H EH NG
һайханаар	HH EE H EH N AA R
һайханай	HH EE H EH N EE
һайханиие	HH EE H EH NJ II J EH
һайханиинь	HH EE H EH NJ II NJ
һайхашаагдаа	HH EE H EH SH AA G D AA
һайшаалтай	HH EE SH AA L T EE
һалбаран	HH A L V EH R EH NG
һалбарида	HH A L V EH RJ I D EH
һалхин	HH A L HJ I NG
һалхинай	HH A L HJ I N EE
һамбаашалан	HH A M B AA SH EH L EH NG
һанаа	HH A N AA
һанааб	HH A N AA P
һанаагаа	HH A N AA Gr AA
һанаагаараа	HH A N AA Gr AA R AA
һанаархалга	HH A N AA R H EH L Gr EH
һанаатай	HH A N AA T EE
һанаатайб	HH A N AA T EE P
һанаатайбди	HH A N AA T EE B DJ I
һанааһаань	HH A N AA HH AA NJ
һанагдаа	HH A N EH G D AA
һанагдана	HH A N EH G D EH N EH
һанагшаб	HH A N EH G SH EH P
һанадаг	HH A N D EH K
һанадаггүйб	HH A N EH D EH G Gr UIs P
һанажа	HH A N EH ZH EH
һанал	HH A N EH L
һанамжа	HH A N EH M ZH EH
һанамжануудые	HH A N EH M ZH EH N UUh D Y J EH
һананаб	HH A N EH N EH P
һананагүйб	HH A N EH N EH G UIs P
һананам	HH A N EH N EH M
һанахаар	HH A N EH H AA R
һанахада	HH A N EH H EH D EH
һанашадагби	HH A N EH SH EH D EH G BJ I
һанаһан	HH A N EH HH EH NG
һандарааб	HH A N D EH R AA P
һандараагүй	HH A N D EH R AA Gr UIs
һандарал	HH A N D EH R EH L
һандаралай	HH A N D EH R EH L EE
һандаранхай	HH A N D EH R EH N H EE
һандаргагдажа	HH A N D EH R Gr EH G D EH ZH EH
һандаргажа	HH A N D EH R Gr EH ZH EH
һандархада	HH A N D EH R H EH D EH
һарада	HH A R EH D EH
һарбайнаб	HH A R V EE N EH P
һаруулхан	HH A R UUh L H EH NG
һархяаг	HH A R HJ AA K
һарын	HH A R Y NG
һаяхан	HH A J EH H EH NG
һаяхана	HH A J EH H EH N EH
һмм	HH M
һогтуу	HH O K T UUh
һолонго	HH O L EH NG G EH
һонин	HH O NJ I NG
һонирхобобди	HH O NJ I R H EH V EH B DJ I
һонирходог	HH O NJ I R H EH D EH K
һонирхол	HH O NJ I R H EH L
һонирхолой	H O NJ I R H EH L EE
һонирхолтой	H O NJ I R H EH L T EE
һонирхолтойгоор	HH O NJ I R H EH L T EH R EE Gr OOh R
һонирхооб	HH O NJ I R H OOh P
һонирхоод	HH O NJ I R H OOh T
һонирхохо	HH O NJ I R H EH H EH
һонирхоһон	HH O NJ I R H EH HH EH NG
һонирхуулна	HH O NJ I R H UUh L N EH
һонирхуулха	HH O NJ I R H UUh L H EH
һонор	HH O N EH R
һорилго	HH O RJ I L Gr EH
һорилгодоо	HH O RJ I L Gr EH D OOh
һубиһандал	HH Uh VJ I HH EH N D EH L
һударһаа	HH Uh D EH R HH AA
һунгаа	HH Uh NG G AA
һунгажа	HH Uh NG G EH ZH EH
һураа	HH Uh R AA
һураад	HH Uh R AA T
һурагшад	HH Uh R EH K SH EH T
һурагшадтаа	HH Uh R EH K SH EH T T AA
һурадаг	HH Uh R EH D EH K
һуража	HH Uh R EH ZH EH
һуралсал	HH Uh R EH L S EH L
һуралсалай	HH Uh R EH L S EH L EE
һурана	HH Uh R EH N EH
һурахадаа	HH Uh R EH H EH D AA
һурахадатнай	HH Uh R EH H EH D EH T N EE
һурахаш	HH Uh R EH H EH SH
һурахаяа	HH Uh R EH H EH J AA
һурахын	HH Uh R EH H Y NG
һураһан	HH Uh R EH HH EH NG
һургаа	HH Uh R Gr AA
һургажа	HH Uh R Gr EH ZH EH
һургажархихань	HH Uh R Gr EH ZH EH R HJ I H EH NJ
һургал	HH Uh R Gr EH L
һурган	HH Uh R Gr EH NG
һургаха	HH Uh R Gr EH H EH
һургуули	HH Uh R Gr UUh LJ I
һургуулигүй	HH Uh R Gr UUh LJ I Gr UIs
һургуулида	HH Uh R Gr UUh LJ I D EH
һургуулиин	HH Uh R Gr UUh LJ II NG
һургуулиингаа	HH Uh R Gr UUh LJ II NG G AA
һургуулинууд	HH Uh R Gr UUh LJ I N UUh T
һургуулинуудай	HH Uh R Gr UUh LJ I N UUh D EE
һургуулинуудтай	HH Uh R Gr UUh LJ I N UUh T T EE
һургуулитай	HH Uh R Gr UUh LJ I T EE
һургуулияа	HH Uh R Gr UUh LJ I J AA
һуугаа	HH UUh Gr AA
һуури	HH UUh RJ I
һуурида	HH UUh RJ I D EH
һуурин	HH UUh RJ I NG
һуурингуудай	HH UUh RJ I NG UUh D EE
һууринуудые	HH UUh RJ I N UUh D Y J EH
һууринһаа	HH UUh RJ I N HH AA
һуухадам	HH UUh H EH D EH M
һуха	HH Uh H EH
һэдэлгэнь	HH E D EH L Gr EH NJ
һэжэрээ	HH E ZH EH R EE
һэлгэлдэн	HH E L Gr EH L D EH NG
һэм	HH E M
һэмби	HH E M BJ I
һэмди	HH E M DJ I
һэн	HH EH NG
һэргэлгын	HH E R Gr EH L G Y NG
һэргэлгэ	HH E R Gr EH L Gr EH
һэргээе	HH E R Gr EE J EH
һэргээжэ	HH E R Gr EE ZH EH
һэргээхын	HH E R Gr EE H Y NG
һэргээхэ	HH E R Gr EE H EH
һэргээхэбди	HH E R Gr EE H EH B DJ I
һэрюулээш	HH E RJ UUh L EE SH
һээ	HH EE
һү	HH Us
һүбэлгэн	HH Us V EH L Gr EH NG
һүзэгтэдтэй	HH Us Z EH K T EH T T EE
һүлдэ	HH Us L D EH
һүн	HH Us NG
һүни	HH Us NJ I
һүрөөтэй	HH Us R OOs T EE
һүүлдэ	HH UUs L D EH
һүүлдэнь	HH UUs L D EH NJ
һүүлшын	HH UUs L SH Y NG
һүүлэй	HH UUs L EE
һүүлээр	HH UUs L EE R
һүүлээрнь	HH UUs L EE R NJ
һүүн	HH UUs NG
һүүтэй	HH UUs T EE
һөөргэнь	HH OOs R EH NJ
һөөргөө	HH OOs R Gr OOs
өөрсэ	OOs R S EH
өөрын	OOs R Y NG
өөрынгөө	OOs R Y NG G OOs
өөрынхеэрээл	OOs R Y N HJ EE R EE L
өөрөө	OOs R OOs
өөрөөшье	OOs R OOs SH J EH
өөһэд	OOs HH EH T
өөһэдын	OOs HH EH D Y NG
өөһэдөө	OOs HH EH D OOs
өөһэнөө	OOs HH EH N OOs
шэмээгуй    SH E M EE Gr UIs
унгэроолда  Uh NG G EH R OOh L D A
эжынэрынь   E ZH Y N EH R Y NJ
багтаамжа   B A K T AA M ZH EH
амисгалан   A MJ I S H EH L EH NG
бужагануулһан   B Uh ZH EH Gr EH N UUh L HH EH NG
нэнгээд N E NG G EE T
хормойдо    H O R M EE D EH
адармаатайхан   A D EH R M AA T EE H EH NG
үбгөө   Us V G OOs
яларуулжа   J A L EH R UUh L ZH EH
худалдажа   H Uh D EH L D EH ZH EH
хуйтэндэ    H UIh T EH N D EH
хойноһоо
гэн
шүлэгөөрөө
сэсэг
хоорхыео
эхэнэршэни  E H EH N EH R SH EH NG
эрьелдэнэ   E RJ J EH L D EH N EH
хадуурхагүйл    H A D UUh R H EH Gr UIs L
орьёлые O RJ J O L Y J EH
мүнхэлбэ    M Us N H E L V EH
ялагдангуй
уһаш    Uh HH EH SH
мүнхын  M Us NG H Y NG
аршаандаш   A R SH AA N D EH SH
хоорхыео
найргуй
эбдэһэн
гү Gr Us
ерээдуйтээнь    J E R EE D UIh T EE NJ
болеол
турьяан T Uh RJ J AA NG
бии B Y
үргэн
дотороороо
айлгахагуйм
элшээр
таһараа
залираадүйдэ
гарни
гүбди
ургэлжэлуулжэ
голни
баяртайбди
дамжуулагдаа
урданьхэмжэшэгүй
цогсоһоо
адляар
долгилыш
забдагуй
мартагдашагуй
табисан
хойноһоонь
буляажа
ёһолнод
тогтотохонь
хахадсүлэй
ойроньтүгдэршэгүй
бадаруулая
болёод
ерээдүйнгөө
биолог
толгойгороо
дуратайлди
бугуйбша
богжын
тэбшээритээдэнь
хундхоожэ
дууланалби
хуугэдтоо
сэдьхэлтэйдэнь
худалдажа
сулоогуй
бадаржа
нютагшни
хэнтий
хоюлаа
сэбэрлхээ
гарая
шимни
юртэмсымни
һанаатайлди
ая ганга
хорвоо
долгёор
тумэноороо
оеногуй
алдуу
алдартайханаар
агаарташ
ганган
бол
моригуй
хоюлаа