тэнжээгты	T E N ZH EE K T Y
нүхэдтөө	N U H EH T T OO
эжынгэй	E ZH Y NG G EE
үдэрэй	U D EH R EE
хүрьһэтэ	H U RJ HH EH T EH
ябаг	J A V EH K
үндэрые	U N D EH R Y J EH
болгогты	B O L Gr EH G T Y
одон	O D EH NG
омог	O M EH K
инагхан	I N EH G H EH NG
һалбаржа	HH A L V EH R ZH EH
зээнэрээ	Z EE N EH R EE
эхеэрээ	E HJ EE R EE
хотоймо	H O T EE M EH
ябагты	J A V EH K T Y
тойруулан	T O E R UU L EH NG
һуухань	HH UU H EH NJ
сэгээ	S E Gr EE
бологты	B O L EH G T Y
амжалтатай	A M ZH EH L T EH T EE
хэрэгүүдтээ	H E R EH Gr UU T T EE
цк	C Y K
анхаран	A N H EH R EH NG
залуушулнай	Z A L UU SH UU L N EE
суутайхан	S UU T EE H EH NG
дуунуудтай	D UU N UU T T EE
илдамхан	I L D A M H EH NG
үргэлжэлүүлжэ	U R Gr EH L ZH E L UU L ZH EH L ZH EH
толгойтонһоо	T O L Gr EE T EH N HH EH
шагнан	SH A G N EH NG
түбхинэгты	T U P HJ I N EH K T Y
үреэлтэй	U RJ EE L T EE
сэлгеэ	S E L Gr EE
һанагты	HH A N EH K T Y
заягаа	Z A J AA Gr AA
ажабайдалые	A ZH EH V EE D EH L Y J EH
басагадтай	B A S EH Gr EH T T EE
үүлэн	UU L EH NG
толо	T O L EH
һуугыт	HH UU Gr Y T
эдэй	E D EE
холботой	H O L V EH T EE
оройгоороо	O R EE Gr OO R OO R
нүхэдтэй	N U H EH T T EE
тэнгэри	T E NG G EH RJ I
